//MAP CONVERTED BY dmm2tgm.py THIS HEADER COMMENT PREVENTS RECONVERSION, DO NOT REMOVE
"a" = (
/turf/open/misc/asteroid/airless,
/area/ruin/space/has_grav/outdoors)
"b" = (
/turf/template_noop,
/area/ruin/space/has_grav/outdoors)
"c" = (
/mob/living/basic/trooper/pirate/ranged/space,
/turf/open/misc/asteroid/airless,
/area/ruin/space/has_grav/outdoors)
"d" = (
/obj/effect/turf_decal/stripes/asteroid/line{
	dir = 4
	},
/obj/effect/mob_spawn/corpse/human/engineer/mod,
/turf/open/misc/asteroid/airless,
/area/ruin/space/has_grav/outdoors)
"g" = (
/obj/effect/turf_decal/sand/plating,
/obj/structure/table/reinforced,
/obj/item/flatpacked_machine/boulder_collector,
/turf/open/floor/plating/airless,
/area/ruin/space/has_grav/outdoors)
"h" = (
/obj/effect/turf_decal/stripes/asteroid/line{
	dir = 5
	},
/turf/open/misc/asteroid/airless,
/area/ruin/space/has_grav/outdoors)
"i" = (
/obj/effect/turf_decal/sand/plating,
/obj/structure/table/reinforced,
/obj/item/storage/toolbox/emergency/turret/mag_fed/colonist,
/turf/open/floor/plating/airless,
/area/ruin/space/has_grav/outdoors)
"k" = (
/obj/item/turret_assembly/duster,
/obj/effect/decal/cleanable/oil,
/turf/open/misc/asteroid/airless,
/area/ruin/space/has_grav/outdoors)
"l" = (
/obj/effect/turf_decal/stripes/asteroid/line{
	dir = 10
	},
/turf/open/misc/asteroid/airless,
/area/ruin/space/has_grav/outdoors)
"m" = (
/obj/structure/ore_vent/ghost_mining,
/turf/open/misc/asteroid/airless,
/area/ruin/space/has_grav/outdoors)
"n" = (
/obj/effect/turf_decal/stripes/asteroid/line{
	dir = 8
	},
/obj/effect/mob_spawn/corpse/human/engineer/mod,
/turf/open/misc/asteroid/airless,
/area/ruin/space/has_grav/outdoors)
"o" = (
/obj/effect/turf_decal/stripes/asteroid/line,
/obj/effect/mob_spawn/corpse/human/engineer/mod,
/turf/open/misc/asteroid/airless,
/area/ruin/space/has_grav/outdoors)
"p" = (
/obj/structure/lattice/catwalk,
/turf/template_noop,
/area/ruin/space/has_grav/outdoors)
"s" = (
/obj/effect/turf_decal/stripes/asteroid/line{
	dir = 1
	},
/turf/open/misc/asteroid/airless,
/area/ruin/space/has_grav/outdoors)
"t" = (
/obj/effect/turf_decal/sand/plating,
/obj/structure/table/reinforced,
/obj/item/ammo_box/magazine/c40sol_rifle/standard,
/obj/item/ammo_box/magazine/c40sol_rifle/standard,
/turf/open/floor/plating/airless,
/area/ruin/space/has_grav/outdoors)
"u" = (
/obj/effect/turf_decal/stripes/asteroid/line,
/turf/open/misc/asteroid/airless,
/area/ruin/space/has_grav/outdoors)
"v" = (
/obj/effect/turf_decal/stripes/asteroid/line{
	dir = 9
	},
/turf/open/misc/asteroid/airless,
/area/ruin/space/has_grav/outdoors)
"w" = (
/obj/effect/turf_decal/stripes/asteroid/corner{
	dir = 1
	},
/turf/open/misc/asteroid/airless,
/area/ruin/space/has_grav/outdoors)
"A" = (
/obj/effect/turf_decal/sand/plating,
/turf/open/floor/plating/airless,
/area/ruin/space/has_grav/outdoors)
"B" = (
/obj/effect/turf_decal/stripes/asteroid/line{
	dir = 4
	},
/mob/living/basic/trooper/pirate/ranged/space,
/turf/open/misc/asteroid/airless,
/area/ruin/space/has_grav/outdoors)
"C" = (
/obj/item/weaponcrafting/receiver,
/turf/open/misc/asteroid/airless,
/area/ruin/space/has_grav/outdoors)
"F" = (
/obj/effect/turf_decal/stripes/asteroid/line{
	dir = 4
	},
/turf/open/misc/asteroid/airless,
/area/ruin/space/has_grav/outdoors)
"G" = (
/obj/effect/turf_decal/sand/plating,
/obj/effect/turf_decal/stripes/asteroid/line,
/turf/open/misc/asteroid/airless,
/area/ruin/space/has_grav/outdoors)
"J" = (
/mob/living/basic/trooper/pirate/melee/space,
/turf/open/misc/asteroid/airless,
/area/ruin/space/has_grav/outdoors)
"K" = (
/obj/structure/lattice,
/turf/template_noop,
/area/ruin/space/has_grav/outdoors)
"L" = (
/obj/effect/turf_decal/stripes/asteroid/corner{
	dir = 4
	},
/turf/open/misc/asteroid/airless,
/area/ruin/space/has_grav/outdoors)
"O" = (
/obj/effect/turf_decal/stripes/asteroid/line,
/mob/living/basic/trooper/pirate/ranged/space,
/turf/open/misc/asteroid/airless,
/area/ruin/space/has_grav/outdoors)
"P" = (
/obj/effect/turf_decal/stripes/asteroid/line{
	dir = 1
	},
/mob/living/basic/trooper/pirate/melee/space,
/turf/open/misc/asteroid/airless,
/area/ruin/space/has_grav/outdoors)
"Q" = (
/obj/effect/turf_decal/sand/plating,
/obj/structure/table/reinforced,
/obj/item/t_scanner/adv_mining_scanner,
/turf/open/floor/plating/airless,
/area/ruin/space/has_grav/outdoors)
"S" = (
/obj/effect/turf_decal/stripes/asteroid/line{
	dir = 8
	},
/turf/open/misc/asteroid/airless,
/area/ruin/space/has_grav/outdoors)
"T" = (
/obj/machinery/spaceship_navigation_beacon,
/obj/effect/turf_decal/sand/plating,
/turf/open/floor/plating/airless,
/area/ruin/space/has_grav/outdoors)
"X" = (
/turf/template_noop,
/area/template_noop)
"Y" = (
/obj/effect/turf_decal/stripes/asteroid/line{
	dir = 6
	},
/turf/open/misc/asteroid/airless,
/area/ruin/space/has_grav/outdoors)
"Z" = (
/obj/effect/turf_decal/stripes/asteroid/line{
	dir = 1
	},
/mob/living/basic/trooper/pirate/ranged/space,
/turf/open/misc/asteroid/airless,
/area/ruin/space/has_grav/outdoors)

(1,1,1) = {"
X
X
X
X
X
X
X
X
X
X
X
X
X
X
X
X
X
X
X
X
X
X
X
X
X
"}
(2,1,1) = {"
X
X
X
X
X
X
X
X
X
X
X
X
X
X
X
X
X
X
X
X
X
X
X
X
X
"}
(3,1,1) = {"
X
X
X
X
X
X
X
a
a
a
A
g
X
X
X
X
X
X
X
X
X
X
a
a
X
"}
(4,1,1) = {"
X
X
X
X
a
a
a
a
c
a
a
a
a
X
X
X
X
X
X
X
X
a
a
a
X
"}
(5,1,1) = {"
X
X
X
a
a
a
v
S
S
S
l
a
a
a
X
X
X
X
X
X
a
a
a
a
X
"}
(6,1,1) = {"
X
X
X
a
a
a
s
a
a
a
o
a
a
a
a
K
K
K
K
a
a
a
a
a
X
"}
(7,1,1) = {"
X
X
X
a
a
J
s
a
m
a
u
S
S
S
S
p
p
p
S
S
l
a
a
a
X
"}
(8,1,1) = {"
X
X
X
X
a
a
s
a
a
a
u
F
F
F
F
p
p
F
F
L
u
c
a
a
X
"}
(9,1,1) = {"
X
X
X
X
a
a
h
F
F
B
Y
a
a
a
K
K
K
a
a
s
u
a
a
X
X
"}
(10,1,1) = {"
X
X
X
X
X
a
a
s
u
a
a
a
a
K
b
b
A
a
a
s
u
a
a
X
X
"}
(11,1,1) = {"
X
X
X
X
X
X
a
s
u
a
a
a
b
K
b
b
Q
v
S
S
n
l
a
X
X
"}
(12,1,1) = {"
X
X
X
X
X
X
K
p
p
K
b
b
A
A
A
b
a
P
a
a
a
u
a
X
X
"}
(13,1,1) = {"
X
X
X
X
X
X
K
p
p
K
K
K
A
T
A
K
a
s
a
m
a
u
a
X
X
"}
(14,1,1) = {"
X
X
X
t
i
A
K
p
p
K
b
b
A
A
A
b
a
s
C
a
a
u
a
X
X
"}
(15,1,1) = {"
X
X
X
a
a
a
a
s
G
a
a
b
b
K
b
b
a
h
F
F
F
Y
X
X
X
"}
(16,1,1) = {"
X
X
a
a
a
a
a
s
G
a
a
a
b
K
b
b
k
s
O
a
a
a
X
X
X
"}
(17,1,1) = {"
X
a
a
a
v
S
S
S
l
a
J
a
a
K
b
b
a
s
u
a
a
X
X
X
X
"}
(18,1,1) = {"
X
a
a
a
Z
a
a
a
u
a
a
a
a
a
K
K
a
s
u
a
a
X
X
X
X
"}
(19,1,1) = {"
X
a
a
a
s
a
m
a
u
S
S
S
S
S
p
p
S
w
u
a
X
X
X
X
X
"}
(20,1,1) = {"
X
a
a
a
s
a
a
a
u
F
F
F
F
F
p
p
F
F
Y
X
X
X
X
X
X
"}
(21,1,1) = {"
X
a
a
a
h
F
F
d
Y
c
a
a
a
a
K
K
a
a
X
X
X
X
X
X
X
"}
(22,1,1) = {"
X
a
a
a
a
a
a
a
a
a
a
a
a
X
X
X
X
X
X
X
X
X
X
X
X
"}
(23,1,1) = {"
X
X
a
a
a
a
a
a
a
a
a
a
X
X
X
X
X
X
X
X
X
X
X
X
X
"}
(24,1,1) = {"
X
X
X
X
X
X
X
X
X
X
X
X
X
X
X
X
X
X
X
X
X
X
X
X
X
"}
(25,1,1) = {"
X
X
X
X
X
X
X
X
X
X
X
X
X
X
X
X
X
X
X
X
X
X
X
X
X
"}
