//MAP CONVERTED BY dmm2tgm.py THIS HEADER COMMENT PREVENTS RECONVERSION, DO NOT REMOVE
"a" = (
/obj/machinery/conveyor{
	dir = 8;
	id = "QMLoad2"
	},
/turf/open/floor/iron/dark/textured_large,
/area/shuttle/supply)
"c" = (
/obj/machinery/conveyor{
	dir = 8;
	id = "QMLoad2"
	},
/obj/machinery/conveyor{
	dir = 4;
	id = "QMLoad2"
	},
/turf/open/floor/iron/dark/textured_large,
/area/shuttle/supply)
"e" = (
/obj/machinery/conveyor{
	dir = 4;
	id = "QMLoad2"
	},
/turf/open/floor/iron/dark/textured_large,
/area/shuttle/supply)
"f" = (
/obj/machinery/light/directional/east,
/obj/machinery/button/door/directional/east{
	id = "QMLoaddoor2";
	name = "Loading Doors";
	pixel_y = 8
	},
/obj/machinery/button/door/directional/east{
	id = "QMLoaddoor";
	name = "Loading Doors";
	pixel_y = -8
	},
/turf/open/floor/iron/dark/textured_large,
/area/shuttle/supply)
"g" = (
/obj/machinery/door/poddoor{
	id = "QMLoaddoor";
	name = "Supply Dock Loading Door"
	},
/turf/open/floor/plating,
/area/shuttle/supply)
"h" = (
/turf/closed/wall/mineral/plastitanium,
/area/shuttle/supply)
"i" = (
/turf/open/floor/iron/dark/small,
/area/shuttle/supply)
"k" = (
/obj/effect/turf_decal/stripes/line,
/turf/open/floor/iron/dark/small,
/area/shuttle/supply)
"l" = (
/obj/machinery/conveyor{
	dir = 4;
	id = "QMLoad2"
	},
/obj/machinery/conveyor{
	dir = 8;
	id = "QMLoad2"
	},
/obj/effect/turf_decal/stripes/line{
	dir = 1
	},
/turf/open/floor/iron/dark/textured_large,
/area/shuttle/supply)
"n" = (
/obj/effect/turf_decal/loading_area{
	dir = 4
	},
/turf/open/floor/iron/dark/textured_large,
/area/shuttle/supply)
"o" = (
/obj/machinery/light/directional/north,
/turf/open/floor/iron/dark/textured_large,
/area/shuttle/supply)
"p" = (
/obj/effect/spawner/structure/window/reinforced/shuttle,
/turf/open/floor/plating,
/area/shuttle/supply)
"s" = (
/obj/effect/turf_decal/loading_area{
	dir = 8
	},
/turf/open/floor/iron/dark/textured_large,
/area/shuttle/supply)
"x" = (
/obj/structure/sign/departments/cargo/directional/west,
/obj/machinery/light/directional/west,
/turf/open/floor/iron/dark/textured_large,
/area/shuttle/supply)
"y" = (
/obj/structure/window/reinforced/spawner/directional/north,
/obj/machinery/power/shuttle_engine/heater,
/turf/open/floor/plating/airless,
/area/shuttle/supply)
"z" = (
/obj/effect/turf_decal/delivery,
/turf/open/floor/iron/dark/small,
/area/shuttle/supply)
"C" = (
/turf/closed/wall/mineral/titanium,
/area/shuttle/supply)
"E" = (
/obj/machinery/door/airlock/shuttle{
	name = "Supply Shuttle Airlock"
	},
/obj/effect/mapping_helpers/airlock/access/all/supply/general,
/turf/open/floor/iron/dark/textured_large,
/area/shuttle/supply)
"F" = (
/obj/machinery/door/airlock/shuttle{
	name = "Supply Shuttle Airlock"
	},
/obj/effect/mapping_helpers/airlock/access/all/supply/general,
/obj/docking_port/mobile/supply,
/turf/open/floor/iron/dark/textured_large,
/area/shuttle/supply)
"H" = (
/obj/effect/turf_decal/bot,
/turf/open/floor/iron/dark/small,
/area/shuttle/supply)
"I" = (
/obj/effect/turf_decal/stripes/line,
/turf/open/floor/iron/dark/textured_large,
/area/shuttle/supply)
"J" = (
/obj/machinery/light/directional/south,
/turf/open/floor/iron/dark/textured_large,
/area/shuttle/supply)
"N" = (
/obj/machinery/power/shuttle_engine/propulsion,
/turf/open/floor/plating/airless,
/area/shuttle/supply)
"O" = (
/turf/open/floor/iron/dark/textured_large,
/area/shuttle/supply)
"U" = (
/obj/machinery/power/shuttle_engine/heater,
/obj/structure/window/reinforced/spawner/directional/north,
/turf/open/floor/plating/airless,
/area/shuttle/supply)
"W" = (
/obj/effect/turf_decal/stripes/line{
	dir = 1
	},
/turf/open/floor/iron/dark/textured_large,
/area/shuttle/supply)
"Y" = (
/obj/machinery/door/poddoor{
	id = "QMLoaddoor2";
	name = "Supply Dock Loading Door"
	},
/turf/open/floor/plating,
/area/shuttle/supply)
"Z" = (
/obj/machinery/door/poddoor{
	id = null;
	name = "Supply Dock Loading Door"
	},
/turf/open/floor/plating,
/area/shuttle/supply)

(1,1,1) = {"
C
p
C
Z
E
C
E
Z
C
p
C
y
N
"}
(2,1,1) = {"
C
H
k
e
W
x
I
l
i
H
C
C
h
"}
(3,1,1) = {"
C
H
i
n
O
H
O
s
i
H
C
U
N
"}
(4,1,1) = {"
C
o
O
O
O
z
O
O
O
J
C
U
N
"}
(5,1,1) = {"
C
H
i
n
O
H
O
s
i
H
C
U
N
"}
(6,1,1) = {"
C
H
k
c
W
f
I
a
i
H
C
C
h
"}
(7,1,1) = {"
C
p
C
Y
E
C
F
g
C
p
C
y
N
"}
