//MAP CONVERTED BY dmm2tgm.py THIS HEADER COMMENT PREVENTS RECONVERSION, DO NOT REMOVE
"a" = (
/obj/effect/turf_decal/stripes/line,
/turf/open/floor/iron/dark/textured_large,
/area/shuttle/supply)
"b" = (
/obj/effect/turf_decal/stripes/line{
	dir = 1
	},
/turf/open/floor/iron/dark/small,
/area/shuttle/supply)
"e" = (
/obj/machinery/conveyor{
	dir = 4;
	id = "QMLoad2"
	},
/turf/open/floor/iron/dark/textured_large,
/area/shuttle/supply)
"g" = (
/obj/machinery/light/directional/south,
/turf/open/floor/iron/dark/textured_large,
/area/shuttle/supply)
"j" = (
/turf/closed/wall/mineral/plastitanium,
/area/shuttle/supply)
"l" = (
/turf/open/floor/iron/dark/textured_large,
/area/shuttle/supply)
"m" = (
/obj/machinery/door/poddoor{
	id = null;
	name = "Supply Dock Loading Door"
	},
/turf/open/floor/plating,
/area/shuttle/supply)
"n" = (
/obj/effect/turf_decal/delivery,
/turf/open/floor/iron/dark/small,
/area/shuttle/supply)
"o" = (
/obj/structure/sign/departments/cargo/directional/west,
/obj/machinery/light/directional/west,
/turf/open/floor/iron/dark/textured_large,
/area/shuttle/supply)
"p" = (
/obj/structure/window/reinforced/spawner/directional/north,
/obj/machinery/power/shuttle_engine/heater,
/turf/open/floor/plating/airless,
/area/shuttle/supply)
"s" = (
/obj/machinery/conveyor{
	dir = 4;
	id = "QMLoad2"
	},
/obj/machinery/conveyor{
	dir = 8;
	id = "QMLoad2"
	},
/turf/open/floor/iron/dark/textured_large,
/area/shuttle/supply)
"t" = (
/obj/effect/turf_decal/stripes/line{
	dir = 1
	},
/turf/open/floor/iron/dark/textured_large,
/area/shuttle/supply)
"y" = (
/obj/effect/turf_decal/bot,
/turf/open/floor/iron/dark/small,
/area/shuttle/supply)
"z" = (
/obj/machinery/door/poddoor{
	id = "QMLoaddoor2";
	name = "Supply Dock Loading Door"
	},
/turf/open/floor/plating,
/area/shuttle/supply)
"A" = (
/obj/machinery/conveyor{
	dir = 8;
	id = "QMLoad2"
	},
/turf/open/floor/iron/dark/textured_large,
/area/shuttle/supply)
"E" = (
/turf/closed/wall/mineral/titanium,
/area/shuttle/supply)
"H" = (
/obj/machinery/light/directional/north,
/turf/open/floor/iron/dark/textured_large,
/area/shuttle/supply)
"I" = (
/obj/effect/turf_decal/loading_area{
	dir = 8
	},
/turf/open/floor/iron/dark/textured_large,
/area/shuttle/supply)
"K" = (
/obj/machinery/power/shuttle_engine/propulsion,
/turf/open/floor/plating/airless,
/area/shuttle/supply)
"L" = (
/obj/machinery/power/shuttle_engine/heater,
/obj/structure/window/reinforced/spawner/directional/north,
/turf/open/floor/plating/airless,
/area/shuttle/supply)
"M" = (
/obj/machinery/door/poddoor{
	id = "QMLoaddoor";
	name = "Supply Dock Loading Door"
	},
/turf/open/floor/plating,
/area/shuttle/supply)
"N" = (
/obj/machinery/door/airlock/shuttle{
	name = "Supply Shuttle Airlock"
	},
/obj/effect/mapping_helpers/airlock/access/all/supply/general,
/obj/docking_port/mobile/supply,
/turf/open/floor/iron/dark/textured_large,
/area/shuttle/supply)
"P" = (
/obj/effect/spawner/structure/window/reinforced/shuttle,
/turf/open/floor/plating,
/area/shuttle/supply)
"Q" = (
/obj/machinery/light/directional/east,
/obj/machinery/button/door/directional/east{
	id = "QMLoaddoor2";
	name = "Loading Doors";
	pixel_y = 8
	},
/obj/machinery/button/door/directional/east{
	id = "QMLoaddoor";
	name = "Loading Doors";
	pixel_y = -8
	},
/turf/open/floor/iron/dark/textured_large,
/area/shuttle/supply)
"R" = (
/obj/effect/turf_decal/loading_area{
	dir = 4
	},
/turf/open/floor/iron/dark/textured_large,
/area/shuttle/supply)
"T" = (
/obj/machinery/door/airlock/shuttle{
	name = "Supply Shuttle Airlock"
	},
/obj/effect/mapping_helpers/airlock/access/all/supply/general,
/turf/open/floor/iron/dark/textured_large,
/area/shuttle/supply)
"W" = (
/obj/machinery/conveyor{
	dir = 8;
	id = "QMLoad2"
	},
/obj/machinery/conveyor{
	dir = 4;
	id = "QMLoad2"
	},
/turf/open/floor/iron/dark/textured_large,
/area/shuttle/supply)
"X" = (
/turf/open/floor/iron/dark/small,
/area/shuttle/supply)
"Z" = (
/obj/effect/turf_decal/stripes/line,
/turf/open/floor/iron/dark/small,
/area/shuttle/supply)

(1,1,1) = {"
E
P
P
E
E
m
T
E
T
m
E
E
P
P
E
p
K
"}
(2,1,1) = {"
E
y
X
X
Z
e
t
o
a
s
b
X
X
y
E
E
j
"}
(3,1,1) = {"
E
y
X
X
X
R
l
y
l
I
X
X
X
y
E
L
K
"}
(4,1,1) = {"
E
H
l
l
l
l
l
n
l
l
l
l
l
g
E
L
K
"}
(5,1,1) = {"
E
y
X
X
X
R
l
y
l
I
X
X
X
y
E
L
K
"}
(6,1,1) = {"
E
y
X
X
Z
W
t
Q
a
A
b
X
X
y
E
E
j
"}
(7,1,1) = {"
E
P
P
E
E
z
T
E
N
M
E
E
P
P
E
p
K
"}
