//MAP CONVERTED BY dmm2tgm.py THIS HEADER COMMENT PREVENTS RECONVERSION, DO NOT REMOVE
"aC" = (
/obj/machinery/computer/shuttle/solfed/medical{
	dir = 8
	},
/turf/open/floor/iron/smooth_large,
/area/shuttle/solfed/espatier/trauma)
"bk" = (
/obj/structure/chair/comfy/shuttle{
	dir = 4
	},
/obj/machinery/light/floor,
/turf/open/floor/mineral/titanium/tiled/white,
/area/shuttle/solfed/espatier/trauma)
"bm" = (
/obj/structure/rack/shelf,
/obj/item/storage/medkit/robotic_repair/preemo/stocked,
/obj/item/storage/medkit/robotic_repair/preemo/stocked,
/obj/item/storage/medkit/robotic_repair/preemo/stocked,
/turf/open/floor/iron/dark/textured_large,
/area/shuttle/solfed/espatier/trauma)
"br" = (
/obj/structure/closet/crate,
/obj/item/clothing/glasses/meson/night,
/obj/item/clothing/glasses/meson/night,
/obj/item/clothing/glasses/meson/night,
/obj/item/clothing/glasses/meson/night,
/obj/item/clothing/glasses/hud/security/night,
/obj/item/clothing/glasses/hud/security/night,
/obj/item/clothing/glasses/hud/security/night,
/obj/item/clothing/glasses/hud/security/night,
/obj/item/clothing/glasses/hud/health/night/meson,
/obj/item/clothing/glasses/hud/health/night/meson,
/obj/item/clothing/glasses/hud/health/night/meson,
/obj/item/clothing/glasses/hud/health/night/meson,
/turf/open/floor/iron/dark/textured_large,
/area/shuttle/solfed/espatier/trauma)
"bC" = (
/obj/machinery/atmospherics/components/trinary/filter/atmos/flipped/co2,
/obj/machinery/atmospherics/pipe/smart/simple/cyan/hidden/layer4{
	dir = 4
	},
/turf/open/floor/iron/white/textured_half,
/area/shuttle/solfed/espatier/trauma)
"bG" = (
/obj/structure/closet/crate/freezer/blood{
	anchored = 1
	},
/turf/open/floor/mineral/titanium/tiled/white,
/area/shuttle/solfed/espatier/trauma)
"df" = (
/obj/structure/table/reinforced/rglass,
/obj/item/storage/box/beakers/variety,
/obj/item/storage/box/beakers/variety,
/obj/item/storage/box/beakers/variety,
/turf/open/floor/iron/dark/textured_large,
/area/shuttle/solfed/espatier/trauma)
"dU" = (
/obj/machinery/atmos_shield_gen/active{
	dir = 8
	},
/obj/machinery/door/airlock/external/glass,
/turf/open/floor/iron/smooth_half{
	dir = 1
	},
/area/shuttle/solfed/espatier/trauma)
"ei" = (
/obj/machinery/light/floor,
/obj/structure/chair/comfy/shuttle{
	dir = 4
	},
/obj/effect/landmark/ert_shuttle_brief_spawn,
/turf/open/floor/iron/smooth_large,
/area/shuttle/solfed/espatier/trauma)
"ew" = (
/obj/machinery/computer/operating,
/obj/machinery/light/directional/north,
/turf/open/floor/mineral/titanium/tiled/white,
/area/shuttle/solfed/espatier/trauma)
"eK" = (
/obj/machinery/vending/wallmed/directional/west,
/obj/machinery/atmospherics/pipe/smart/manifold/cyan/hidden{
	dir = 8
	},
/turf/open/floor/mineral/titanium/tiled/white,
/area/shuttle/solfed/espatier/trauma)
"eL" = (
/obj/effect/spawner/random/entertainment/arcade{
	dir = 1
	},
/turf/open/floor/iron/dark/textured_large,
/area/shuttle/solfed/espatier/trauma)
"eN" = (
/obj/machinery/light/floor,
/turf/open/floor/iron/white/textured_half,
/area/shuttle/solfed/espatier/trauma)
"eU" = (
/obj/structure/chair/comfy/shuttle{
	dir = 1
	},
/obj/effect/turf_decal/box/white/corners{
	dir = 8
	},
/obj/effect/turf_decal/box/white/corners{
	dir = 1
	},
/obj/effect/landmark/ert_shuttle_spawn,
/turf/open/floor/iron/dark/textured_large,
/area/shuttle/solfed/espatier/trauma)
"fd" = (
/obj/machinery/portable_atmospherics/canister/nitrogen,
/obj/machinery/atmospherics/components/unary/portables_connector/visible/layer4{
	dir = 1
	},
/turf/open/floor/iron/smooth_large,
/area/shuttle/solfed/espatier/trauma)
"fV" = (
/obj/effect/turf_decal/bot_white,
/obj/structure/table/reinforced/rglass,
/obj/item/stack/sheet/iron/fifty,
/obj/item/stack/sheet/iron/fifty{
	pixel_x = 7
	},
/obj/item/stack/sheet/glass/fifty{
	pixel_y = 4;
	pixel_x = 8
	},
/obj/item/stack/sheet/glass/fifty,
/obj/effect/spawner/random/entertainment/plushie_delux,
/turf/open/floor/iron/dark/textured_large,
/area/shuttle/solfed/espatier/trauma)
"gb" = (
/obj/machinery/stasis,
/turf/open/floor/mineral/titanium/tiled/white,
/area/shuttle/solfed/espatier/trauma)
"gD" = (
/turf/closed/wall/mineral/plastitanium,
/area/shuttle/solfed/espatier/trauma)
"gE" = (
/obj/machinery/atmos_shield_gen/active{
	dir = 1
	},
/obj/machinery/door/poddoor{
	id = "SolfedShipDoor";
	name = "Assault Doors"
	},
/turf/open/floor/plating/airless,
/area/shuttle/solfed/espatier/trauma)
"gZ" = (
/obj/machinery/chem_master,
/turf/open/floor/iron/dark/textured_large,
/area/shuttle/solfed/espatier/trauma)
"hf" = (
/obj/machinery/sleeper{
	dir = 4
	},
/obj/machinery/atmospherics/pipe/smart/simple/cyan/hidden{
	dir = 5
	},
/turf/open/floor/mineral/titanium/tiled/white,
/area/shuttle/solfed/espatier/trauma)
"hX" = (
/obj/machinery/atmospherics/pipe/smart/simple/scrubbers/hidden{
	dir = 5
	},
/obj/machinery/atmospherics/pipe/smart/simple/cyan/hidden/layer4{
	dir = 6
	},
/obj/effect/landmark/ert_shuttle_spawn,
/turf/open/floor/catwalk_floor/iron_smooth,
/area/shuttle/solfed/espatier/trauma)
"iP" = (
/obj/structure/table/reinforced/rglass,
/turf/open/floor/iron/dark/textured_large,
/area/shuttle/solfed/espatier/trauma)
"iY" = (
/turf/open/floor/iron/smooth_edge{
	dir = 1
	},
/area/shuttle/solfed/espatier/trauma)
"jv" = (
/obj/effect/turf_decal/delivery/white,
/obj/machinery/door/airlock/medical/glass{
	name = "Shuttle Chemistry"
	},
/obj/effect/mapping_helpers/airlock/access/all/medical/chemistry,
/turf/open/floor/iron/dark/textured_large,
/area/shuttle/solfed/espatier/trauma)
"jN" = (
/obj/structure/rack/shelf,
/obj/item/storage/medkit/emergency,
/obj/item/storage/medkit/emergency{
	pixel_x = 5;
	pixel_y = 8
	},
/obj/item/storage/medkit/emergency{
	pixel_y = 3;
	pixel_x = 3
	},
/turf/open/floor/iron/dark/textured_large,
/area/shuttle/solfed/espatier/trauma)
"kA" = (
/obj/machinery/computer/camera_advanced{
	dir = 8
	},
/turf/open/floor/iron/smooth_large,
/area/shuttle/solfed/espatier/trauma)
"lm" = (
/obj/effect/landmark/ert_shuttle_spawn,
/turf/open/floor/mineral/titanium/tiled/white,
/area/shuttle/solfed/espatier/trauma)
"lU" = (
/obj/machinery/power/shuttle_engine/heater{
	dir = 8
	},
/obj/structure/window/reinforced/plasma/spawner/directional/east,
/turf/open/floor/plating/airless,
/area/shuttle/solfed/espatier/trauma)
"mf" = (
/obj/machinery/chem_dispenser,
/turf/open/floor/mineral/titanium/tiled/white,
/area/shuttle/solfed/espatier/trauma)
"ms" = (
/obj/machinery/status_display/evac/directional/north,
/obj/machinery/atmospherics/components/unary/thermomachine/freezer/on,
/obj/machinery/light/directional/north,
/turf/open/floor/mineral/titanium/tiled/white,
/area/shuttle/solfed/espatier/trauma)
"mE" = (
/obj/machinery/status_display/evac/directional/north,
/obj/machinery/vending/access/solfed,
/turf/open/floor/iron/smooth_large,
/area/shuttle/solfed/espatier/trauma)
"mX" = (
/obj/structure/chair/comfy/shuttle{
	dir = 1
	},
/obj/effect/turf_decal/box/white/corners{
	dir = 4
	},
/obj/effect/turf_decal/box/white/corners,
/obj/structure/sign/flag/terragov/directional/south,
/obj/effect/landmark/ert_shuttle_spawn,
/turf/open/floor/iron/dark/textured_large,
/area/shuttle/solfed/espatier/trauma)
"nl" = (
/obj/machinery/light/floor,
/turf/open/floor/iron/smooth_half,
/area/shuttle/solfed/espatier/trauma)
"no" = (
/obj/structure/closet/emcloset,
/obj/effect/turf_decal/bot_white,
/turf/open/floor/iron/dark/textured_large,
/area/shuttle/solfed/espatier/trauma)
"nT" = (
/obj/structure/closet/emcloset,
/obj/structure/window/reinforced/spawner/directional/west,
/turf/open/floor/iron/dark/textured_large,
/area/shuttle/solfed/espatier/trauma)
"nZ" = (
/obj/structure/table/optable,
/obj/item/defibrillator/loaded,
/obj/machinery/defibrillator_mount/charging{
	pixel_y = 32
	},
/obj/machinery/anesthetic_machine,
/turf/open/floor/mineral/titanium/tiled/white,
/area/shuttle/solfed/espatier/trauma)
"os" = (
/obj/effect/turf_decal/delivery/white,
/obj/machinery/door/airlock/command/glass{
	name = "Cockpit"
	},
/obj/effect/mapping_helpers/airlock/access/all/command/general,
/obj/effect/mapping_helpers/airlock/cutaiwire,
/turf/open/floor/iron/dark/textured_large,
/area/shuttle/solfed/espatier/trauma)
"ov" = (
/obj/structure/chair/comfy/shuttle,
/obj/effect/turf_decal/box/white/corners{
	dir = 1
	},
/obj/effect/turf_decal/box/white/corners{
	dir = 8
	},
/obj/effect/landmark/ert_shuttle_spawn,
/turf/open/floor/iron/dark/textured_large,
/area/shuttle/solfed/espatier/trauma)
"oN" = (
/obj/machinery/holopad,
/obj/effect/turf_decal/stripes/box,
/turf/open/floor/iron/smooth_large,
/area/shuttle/solfed/espatier/trauma)
"oV" = (
/obj/machinery/atmos_shield_gen/active{
	dir = 4
	},
/obj/machinery/door/airlock/external/glass,
/turf/open/floor/iron/smooth_half{
	dir = 1
	},
/area/shuttle/solfed/espatier/trauma)
"pp" = (
/obj/structure/chair/comfy/shuttle{
	dir = 4
	},
/obj/effect/landmark/ert_shuttle_brief_spawn,
/turf/open/floor/iron/smooth_large,
/area/shuttle/solfed/espatier/trauma)
"pr" = (
/obj/structure/closet/firecloset/full,
/turf/open/floor/iron/dark/textured_large,
/area/shuttle/solfed/espatier/trauma)
"qx" = (
/obj/machinery/light/floor,
/turf/open/floor/mineral/titanium/tiled/white,
/area/shuttle/solfed/espatier/trauma)
"sx" = (
/obj/machinery/suit_storage_unit/standard_unit,
/obj/effect/turf_decal/bot_white,
/turf/open/floor/iron/dark/textured_large,
/area/shuttle/solfed/espatier/trauma)
"sF" = (
/obj/machinery/light/floor,
/obj/machinery/atmospherics/pipe/smart/simple/scrubbers/hidden{
	dir = 4
	},
/obj/machinery/atmospherics/pipe/smart/simple/cyan/hidden/layer4{
	dir = 4
	},
/turf/open/floor/iron/smooth_large,
/area/shuttle/solfed/espatier/trauma)
"sP" = (
/obj/machinery/atmos_shield_gen/active,
/obj/machinery/door/poddoor{
	id = "SolfedShipDoor";
	name = "Assault Doors"
	},
/turf/open/floor/plating/airless,
/area/shuttle/solfed/espatier/trauma)
"sQ" = (
/obj/structure/closet/crate/freezer/blood,
/turf/open/floor/iron/dark/textured_large,
/area/shuttle/solfed/espatier/trauma)
"sY" = (
/obj/machinery/atmospherics/pipe/smart/manifold/cyan/hidden{
	dir = 4
	},
/turf/open/floor/mineral/titanium/tiled/white,
/area/shuttle/solfed/espatier/trauma)
"vR" = (
/obj/machinery/light/floor,
/turf/open/floor/iron/smooth_large,
/area/shuttle/solfed/espatier/trauma)
"vT" = (
/obj/machinery/computer/operating{
	dir = 1
	},
/obj/machinery/light/directional/south,
/turf/open/floor/mineral/titanium/tiled/white,
/area/shuttle/solfed/espatier/trauma)
"vW" = (
/obj/structure/window/reinforced/spawner/directional/west,
/obj/effect/turf_decal/box,
/obj/machinery/suit_storage_unit/standard_unit,
/turf/open/floor/iron/dark/textured_large,
/area/shuttle/solfed/espatier/trauma)
"wh" = (
/obj/structure/chair/comfy/shuttle{
	dir = 1
	},
/obj/effect/turf_decal/box/white/corners{
	dir = 4
	},
/obj/effect/turf_decal/box/white/corners,
/obj/effect/landmark/ert_shuttle_spawn,
/turf/open/floor/iron/dark/textured_large,
/area/shuttle/solfed/espatier/trauma)
"xj" = (
/obj/machinery/status_display/evac/directional/south,
/obj/structure/rack/shelf,
/obj/item/storage/medkit/fire,
/obj/item/storage/medkit/fire,
/obj/item/storage/medkit/brute{
	pixel_y = 6
	},
/obj/item/storage/medkit/brute{
	pixel_y = 6
	},
/turf/open/floor/mineral/titanium/tiled/white,
/area/shuttle/solfed/espatier/trauma)
"xD" = (
/obj/item/gps/computer/space/solfed/medical,
/turf/open/floor/iron/smooth_large,
/area/shuttle/solfed/espatier/trauma)
"yk" = (
/obj/machinery/cryo_cell,
/turf/open/floor/mineral/titanium/tiled/white,
/area/shuttle/solfed/espatier/trauma)
"yD" = (
/obj/structure/closet/crate/freezer{
	anchored = 1
	},
/obj/item/tank/internals/anesthetic,
/obj/item/tank/internals/anesthetic,
/obj/item/tank/internals/anesthetic,
/obj/item/tank/internals/anesthetic,
/turf/open/floor/iron/white/textured_half,
/area/shuttle/solfed/espatier/trauma)
"zL" = (
/obj/machinery/computer/atmos_alert{
	dir = 1
	},
/turf/open/floor/iron/smooth_large,
/area/shuttle/solfed/espatier/trauma)
"Af" = (
/obj/structure/sign/flag/terragov/directional/west,
/obj/machinery/sleeper{
	dir = 4
	},
/turf/open/floor/mineral/titanium/tiled/white,
/area/shuttle/solfed/espatier/trauma)
"AQ" = (
/obj/machinery/door/airlock/engineering{
	name = "Shuttle Engineering"
	},
/turf/open/floor/iron/dark/textured_large,
/area/shuttle/solfed/espatier/trauma)
"Bt" = (
/turf/template_noop,
/area/template_noop)
"BI" = (
/obj/machinery/power/shuttle_engine/propulsion{
	dir = 8
	},
/obj/effect/turf_decal/stripes/line{
	dir = 8
	},
/turf/open/floor/plating/airless,
/area/shuttle/solfed/espatier/trauma)
"Ca" = (
/obj/machinery/atmospherics/pipe/smart/manifold/cyan/hidden{
	dir = 4
	},
/turf/open/floor/iron/white/textured_half,
/area/shuttle/solfed/espatier/trauma)
"Cd" = (
/obj/machinery/computer/camera_advanced/shuttle_docker/solfed/medical{
	dir = 8
	},
/turf/open/floor/iron/smooth_large,
/area/shuttle/solfed/espatier/trauma)
"Cn" = (
/obj/machinery/light/floor,
/turf/open/floor/mineral/plastitanium/red,
/area/shuttle/solfed/espatier/trauma)
"CM" = (
/obj/structure/rack/shelf,
/obj/item/storage/medkit/mechanical{
	pixel_y = 6
	},
/obj/item/storage/medkit/mechanical,
/turf/open/floor/iron/dark/textured_large,
/area/shuttle/solfed/espatier/trauma)
"CQ" = (
/obj/machinery/atmospherics/pipe/smart/simple/scrubbers/hidden{
	dir = 1
	},
/turf/open/floor/catwalk_floor/iron_smooth,
/area/shuttle/solfed/espatier/trauma)
"Dc" = (
/turf/open/floor/mineral/plastitanium/red,
/area/shuttle/solfed/espatier/trauma)
"Dt" = (
/obj/structure/chair/comfy/shuttle,
/obj/machinery/vending/wallmed/directional/north,
/obj/effect/landmark/ert_shuttle_spawn,
/obj/effect/turf_decal/box/white/corners{
	dir = 1
	},
/obj/effect/turf_decal/box/white/corners{
	dir = 8
	},
/turf/open/floor/iron/dark/textured_large,
/area/shuttle/solfed/espatier/trauma)
"DA" = (
/obj/structure/chair/comfy/shuttle,
/obj/effect/landmark/ert_shuttle_brief_spawn,
/turf/open/floor/iron/smooth_large,
/area/shuttle/solfed/espatier/trauma)
"DZ" = (
/turf/open/floor/iron/smooth,
/area/shuttle/solfed/espatier/trauma)
"ER" = (
/turf/open/floor/iron/white/textured_half{
	dir = 1
	},
/area/shuttle/solfed/espatier/trauma)
"FX" = (
/obj/structure/sign/flag/terragov/directional/west,
/obj/machinery/cryo_cell,
/turf/open/floor/mineral/titanium/tiled/white,
/area/shuttle/solfed/espatier/trauma)
"Gl" = (
/obj/machinery/button/door/directional/west{
	id = "SolfedShipDoor";
	name = "Vessel Aft Doors"
	},
/obj/effect/turf_decal/stripes/corner{
	dir = 8
	},
/obj/structure/sign/flag/terragov/directional/north,
/obj/machinery/atmospherics/pipe/smart/simple/scrubbers/hidden{
	dir = 5
	},
/obj/machinery/portable_atmospherics/canister/oxygen,
/turf/open/floor/iron/smooth_large,
/area/shuttle/solfed/espatier/trauma)
"Hr" = (
/obj/structure/tank_dispenser/oxygen,
/turf/open/floor/iron/dark/textured_large,
/area/shuttle/solfed/espatier/trauma)
"HM" = (
/obj/structure/rack/shelf,
/obj/item/storage/medkit/o2,
/obj/item/storage/medkit/toxin{
	pixel_y = 6
	},
/obj/item/storage/medkit/o2,
/obj/item/storage/medkit/toxin{
	pixel_y = 6
	},
/turf/open/floor/mineral/titanium/tiled/white,
/area/shuttle/solfed/espatier/trauma)
"HV" = (
/obj/machinery/atmospherics/pipe/smart/manifold4w/cyan/hidden/layer4,
/turf/open/floor/catwalk_floor/iron_smooth,
/area/shuttle/solfed/espatier/trauma)
"Jb" = (
/obj/structure/table/reinforced,
/turf/open/floor/iron/smooth_large,
/area/shuttle/solfed/espatier/trauma)
"Jp" = (
/obj/structure/chair/comfy/shuttle,
/obj/effect/landmark/ert_shuttle_spawn,
/obj/effect/turf_decal/box/white/corners{
	dir = 4
	},
/obj/effect/turf_decal/box/white/corners,
/turf/open/floor/iron/dark/textured_large,
/area/shuttle/solfed/espatier/trauma)
"Km" = (
/obj/machinery/holopad,
/turf/open/floor/iron/white/textured,
/area/shuttle/solfed/espatier/trauma)
"Ks" = (
/obj/machinery/light/floor,
/obj/machinery/atmospherics/pipe/layer_manifold/cyan{
	dir = 4
	},
/turf/open/floor/iron/white/textured_half,
/area/shuttle/solfed/espatier/trauma)
"Kt" = (
/obj/machinery/atmos_shield_gen/active{
	dir = 4
	},
/obj/docking_port/mobile{
	shuttle_id = "solfed_medical_shuttle";
	launch_status = 0;
	name = "Solfed Hospital Shuttle";
	preferred_direction = 4;
	port_direction = 4
	},
/obj/machinery/door/airlock/external/glass,
/turf/open/floor/iron/smooth_half{
	dir = 1
	},
/area/shuttle/solfed/espatier/trauma)
"KG" = (
/obj/structure/chair/comfy/shuttle{
	dir = 1
	},
/obj/effect/turf_decal/box/white/corners{
	dir = 1
	},
/obj/effect/turf_decal/box/white/corners{
	dir = 8
	},
/obj/effect/landmark/ert_shuttle_spawn,
/turf/open/floor/iron/dark/textured_large,
/area/shuttle/solfed/espatier/trauma)
"KN" = (
/obj/effect/turf_decal/stripes/line{
	dir = 8
	},
/obj/effect/turf_decal/caution/stand_clear{
	dir = 4
	},
/turf/open/floor/iron/smooth_large,
/area/shuttle/solfed/espatier/trauma)
"KP" = (
/turf/open/floor/iron/smooth_large,
/area/shuttle/solfed/espatier/trauma)
"LG" = (
/obj/machinery/vending/wallmed/directional/south,
/obj/structure/chair/comfy/shuttle{
	dir = 1
	},
/obj/effect/turf_decal/box/white/corners{
	dir = 1
	},
/obj/effect/turf_decal/box/white/corners{
	dir = 8
	},
/obj/effect/landmark/ert_shuttle_spawn,
/turf/open/floor/iron/dark/textured_large,
/area/shuttle/solfed/espatier/trauma)
"Md" = (
/obj/effect/spawner/structure/window/reinforced/plasma/plastitanium,
/turf/open/floor/plating,
/area/shuttle/solfed/espatier/trauma)
"Nk" = (
/obj/effect/turf_decal/box,
/obj/machinery/suit_storage_unit/standard_unit,
/turf/open/floor/iron/dark/textured_large,
/area/shuttle/solfed/espatier/trauma)
"NC" = (
/obj/effect/turf_decal/delivery/white,
/obj/machinery/door/airlock/medical/glass{
	name = "Shuttle Medbay"
	},
/turf/open/floor/iron/dark/textured_large,
/area/shuttle/solfed/espatier/trauma)
"OS" = (
/obj/machinery/vending/wallmed/directional/north,
/obj/machinery/atmospherics/pipe/smart/simple/scrubbers/hidden{
	dir = 10
	},
/obj/machinery/portable_atmospherics/canister/oxygen,
/turf/open/floor/iron/smooth_large,
/area/shuttle/solfed/espatier/trauma)
"Pk" = (
/obj/structure/marker_beacon/burgundy,
/turf/closed/wall/mineral/plastitanium,
/area/shuttle/solfed/espatier/trauma)
"Pl" = (
/obj/machinery/status_display/evac/directional/west,
/turf/open/floor/iron/smooth_half,
/area/shuttle/solfed/espatier/trauma)
"Pw" = (
/obj/structure/tank_dispenser/oxygen,
/turf/open/floor/iron/smooth_large,
/area/shuttle/solfed/espatier/trauma)
"PA" = (
/obj/structure/table/optable,
/obj/item/defibrillator/loaded,
/obj/machinery/defibrillator_mount/charging{
	pixel_y = -32
	},
/obj/machinery/anesthetic_machine,
/turf/open/floor/mineral/titanium/tiled/white,
/area/shuttle/solfed/espatier/trauma)
"QM" = (
/obj/structure/chair/comfy/shuttle,
/obj/effect/turf_decal/box/white/corners,
/obj/effect/turf_decal/box/white/corners{
	dir = 4
	},
/obj/effect/landmark/ert_shuttle_spawn,
/turf/open/floor/iron/dark/textured_large,
/area/shuttle/solfed/espatier/trauma)
"QQ" = (
/obj/effect/turf_decal/stripes/line{
	dir = 8
	},
/obj/effect/turf_decal/loading_area/red{
	dir = 8
	},
/turf/open/floor/iron/smooth_large,
/area/shuttle/solfed/espatier/trauma)
"Ru" = (
/turf/open/floor/iron/smooth_edge,
/area/shuttle/solfed/espatier/trauma)
"Rz" = (
/obj/machinery/button/door/directional/west{
	id = "SolfedShipDoor";
	name = "Vessel Aft Doors"
	},
/obj/effect/turf_decal/stripes/corner{
	dir = 1
	},
/obj/machinery/portable_atmospherics/canister/nitrogen,
/obj/machinery/atmospherics/components/unary/portables_connector/visible/layer4{
	dir = 1
	},
/turf/open/floor/iron/smooth_large,
/area/shuttle/solfed/espatier/trauma)
"RY" = (
/obj/structure/marker_beacon,
/turf/closed/wall/mineral/plastitanium,
/area/shuttle/solfed/espatier/trauma)
"So" = (
/obj/machinery/atmospherics/pipe/smart/simple/cyan/hidden{
	dir = 9
	},
/obj/structure/closet/crate/freezer/blood{
	anchored = 1
	},
/turf/open/floor/mineral/titanium/tiled/white,
/area/shuttle/solfed/espatier/trauma)
"TL" = (
/obj/machinery/atmospherics/components/unary/passive_vent,
/turf/open/floor/plating,
/area/shuttle/solfed/espatier/trauma)
"Vi" = (
/obj/machinery/computer/station_alert{
	dir = 1
	},
/turf/open/floor/iron/smooth_large,
/area/shuttle/solfed/espatier/trauma)
"Vr" = (
/obj/structure/table/reinforced/rglass,
/obj/effect/spawner/surgery_tray/full{
	pixel_y = 8
	},
/turf/open/floor/mineral/titanium/tiled/white,
/area/shuttle/solfed/espatier/trauma)
"VP" = (
/obj/effect/turf_decal/stripes/line{
	dir = 8
	},
/obj/effect/turf_decal/loading_area/red{
	dir = 8
	},
/obj/machinery/atmospherics/pipe/smart/simple/cyan/hidden/layer4{
	dir = 6
	},
/turf/open/floor/iron/smooth_large,
/area/shuttle/solfed/espatier/trauma)
"Wa" = (
/turf/open/floor/mineral/titanium/tiled/white,
/area/shuttle/solfed/espatier/trauma)
"Wk" = (
/turf/open/floor/iron/smooth_half,
/area/shuttle/solfed/espatier/trauma)
"Wu" = (
/obj/structure/sign/flag/terragov/directional/north,
/obj/structure/chair/comfy/shuttle,
/obj/effect/turf_decal/box/white/corners{
	dir = 4
	},
/obj/effect/turf_decal/box/white/corners,
/obj/effect/landmark/ert_shuttle_spawn,
/turf/open/floor/iron/dark/textured_large,
/area/shuttle/solfed/espatier/trauma)
"Wv" = (
/turf/open/floor/iron/white/textured_half,
/area/shuttle/solfed/espatier/trauma)
"WD" = (
/obj/effect/turf_decal/delivery/white,
/obj/machinery/atmospherics/pipe/smart/simple/scrubbers/hidden{
	dir = 4
	},
/obj/machinery/atmospherics/pipe/smart/simple/cyan/hidden/layer4{
	dir = 4
	},
/obj/machinery/door/airlock/medical/glass{
	name = "Shuttle Medbay"
	},
/turf/open/floor/iron/dark/textured_large,
/area/shuttle/solfed/espatier/trauma)
"WG" = (
/obj/machinery/chem_heater,
/turf/open/floor/iron/dark/textured_large,
/area/shuttle/solfed/espatier/trauma)
"Xt" = (
/turf/open/floor/iron/smooth_half{
	dir = 1
	},
/area/shuttle/solfed/espatier/trauma)
"Xx" = (
/obj/machinery/light/directional/south,
/turf/open/floor/mineral/titanium/tiled/white,
/area/shuttle/solfed/espatier/trauma)
"XF" = (
/obj/structure/table,
/obj/item/storage/toolbox/mechanical{
	pixel_y = 8
	},
/obj/item/storage/toolbox/mechanical,
/turf/open/floor/iron/smooth_large,
/area/shuttle/solfed/espatier/trauma)
"XM" = (
/obj/machinery/atmospherics/pipe/smart/simple/scrubbers/hidden{
	dir = 1
	},
/turf/closed/wall/mineral/plastitanium,
/area/shuttle/solfed/espatier/trauma)
"XW" = (
/obj/machinery/door/poddoor{
	id = "SolfedShipDoor";
	name = "Assault Doors"
	},
/turf/open/floor/plating/airless,
/area/shuttle/solfed/espatier/trauma)
"Zk" = (
/obj/machinery/atmospherics/pipe/smart/simple/cyan/hidden{
	dir = 8
	},
/obj/effect/landmark/ert_shuttle_spawn,
/turf/open/floor/mineral/titanium/tiled/white,
/area/shuttle/solfed/espatier/trauma)

(1,1,1) = {"
Bt
Bt
Bt
Bt
gD
gD
sP
XW
gE
gD
gD
Bt
Bt
Bt
Bt
"}
(2,1,1) = {"
Bt
Bt
Bt
TL
XM
Gl
QQ
KN
VP
Rz
gD
Bt
Bt
Bt
Bt
"}
(3,1,1) = {"
Bt
RY
BI
BI
gD
OS
CQ
hX
HV
fd
gD
BI
BI
Pk
Bt
"}
(4,1,1) = {"
Bt
gD
lU
lU
gD
Pw
XF
sF
sx
sx
gD
lU
lU
gD
Bt
"}
(5,1,1) = {"
RY
gD
gD
gD
gD
gD
gD
WD
gD
gD
gD
gD
gD
gD
Pk
"}
(6,1,1) = {"
gD
ov
Pl
no
gD
FX
eK
bC
hf
Af
gD
no
Pl
eU
gD
"}
(7,1,1) = {"
gD
Wu
nl
KG
gD
ms
Zk
Ks
Zk
Xx
gD
ov
nl
mX
gD
"}
(8,1,1) = {"
oV
Xt
Ru
wh
gD
yk
sY
Ca
So
bG
gD
QM
iY
Xt
Kt
"}
(9,1,1) = {"
dU
Xt
DZ
Xt
NC
ER
ER
Km
ER
ER
NC
Xt
DZ
Xt
dU
"}
(10,1,1) = {"
Md
nT
Wk
LG
gD
HM
Wa
Wv
Wa
xj
gD
Dt
Wk
nT
Md
"}
(11,1,1) = {"
gD
pr
nl
wh
gD
gb
Wa
eN
Wa
gb
gD
Jp
nl
pr
gD
"}
(12,1,1) = {"
RY
Md
AQ
Md
gD
ew
lm
yD
lm
vT
gD
Md
jv
Md
Pk
"}
(13,1,1) = {"
gD
br
Wk
eL
gD
nZ
Wa
Wv
Wa
PA
gD
jN
Wa
bm
gD
"}
(14,1,1) = {"
Md
fV
Wk
Hr
gD
Vr
Wa
Wv
Wa
Vr
gD
CM
qx
sQ
Md
"}
(15,1,1) = {"
Md
vW
Cn
vW
gD
gD
Md
os
Md
gD
gD
sQ
Wa
sQ
Md
"}
(16,1,1) = {"
Md
Nk
Dc
Nk
gD
xD
KP
vR
DA
Vi
gD
df
bk
iP
Md
"}
(17,1,1) = {"
gD
Nk
Dc
Nk
gD
mE
KP
oN
KP
zL
gD
gZ
mf
WG
gD
"}
(18,1,1) = {"
RY
gD
Md
gD
gD
Jb
pp
ei
Jb
Jb
gD
gD
Md
gD
Pk
"}
(19,1,1) = {"
Bt
Bt
Bt
Bt
Md
aC
kA
Cd
gD
Md
gD
Bt
Bt
Bt
Bt
"}
(20,1,1) = {"
Bt
Bt
Bt
Bt
gD
Md
Md
Md
gD
Bt
Bt
Bt
Bt
Bt
Bt
"}
