//MAP CONVERTED BY dmm2tgm.py THIS HEADER COMMENT PREVENTS RECONVERSION, DO NOT REMOVE
"cZ" = (
/obj/machinery/camera/xray/directional/south{
	pixel_y = 32;
	c_tag = "External View Port-Side";
	network = list("lone_infil_shuttle")
	},
/turf/closed/wall/mineral/plastitanium,
/area/shuttle/lone_infil)
"dc" = (
/obj/structure/cable,
/obj/effect/turf_decal/box/red/corners,
/obj/effect/turf_decal/box/red/corners{
	dir = 8
	},
/obj/structure/chair/comfy/shuttle/tactical{
	dir = 4
	},
/turf/open/floor/mineral/plastitanium,
/area/shuttle/lone_infil)
"ie" = (
/turf/closed/wall/mineral/plastitanium,
/area/shuttle/lone_infil)
"nT" = (
/obj/machinery/power/shuttle_engine/propulsion/burst{
	dir = 8
	},
/turf/closed/wall/mineral/plastitanium/nodiagonal,
/area/shuttle/lone_infil)
"qe" = (
/obj/machinery/computer/shuttle/lone_infil{
	dir = 8
	},
/obj/structure/cable,
/obj/effect/turf_decal/delivery/red,
/turf/open/floor/mineral/plastitanium,
/area/shuttle/lone_infil)
"qu" = (
/turf/closed/wall/mineral/plastitanium/nodiagonal,
/area/shuttle/lone_infil)
"qQ" = (
/obj/machinery/computer/camera_advanced/shuttle_docker/lone_infil,
/obj/effect/turf_decal/delivery/red,
/obj/machinery/light/small/red/directional/north,
/obj/structure/sign/poster/contraband/icebox_moment/directional/north,
/obj/structure/extinguisher_cabinet/directional/east,
/turf/open/floor/mineral/plastitanium,
/area/shuttle/lone_infil)
"tO" = (
/obj/structure/cable,
/obj/machinery/light/floor,
/obj/machinery/power/apc/auto_name/directional/west,
/obj/effect/mapping_helpers/apc/full_charge,
/obj/effect/mapping_helpers/apc/cell_10k,
/obj/effect/mapping_helpers/apc/syndicate_access,
/obj/effect/mapping_helpers/apc/cut_AI_wire,
/obj/machinery/computer/security/telescreen{
	dir = 4;
	network = list("lone_infil_shuttle");
	pixel_x = 32
	},
/obj/effect/turf_decal/box/red/corners{
	dir = 1
	},
/obj/effect/turf_decal/box/red/corners{
	dir = 4
	},
/turf/open/floor/mineral/plastitanium,
/area/shuttle/lone_infil)
"vf" = (
/obj/structure/sign/warning/directional/west,
/turf/template_noop,
/area/template_noop)
"Jv" = (
/turf/template_noop,
/area/template_noop)
"Nn" = (
/obj/structure/cable,
/obj/machinery/recharger{
	pixel_y = 5
	},
/obj/effect/turf_decal/bot_red,
/obj/machinery/light/small/red/directional/south,
/obj/structure/sign/flag/syndicate/directional/south,
/obj/structure/table/reinforced,
/turf/open/floor/mineral/plastitanium,
/area/shuttle/lone_infil)
"UZ" = (
/obj/machinery/power/shuttle_engine/propulsion/burst{
	dir = 8
	},
/turf/closed/wall/mineral/plastitanium,
/area/shuttle/lone_infil)
"Ve" = (
/obj/effect/spawner/structure/window/reinforced/plasma/plastitanium,
/obj/structure/cable,
/obj/machinery/door/poddoor/shutters/preopen{
	dir = 4;
	id = "lone_infil_shutter"
	},
/turf/open/floor/plating,
/area/shuttle/lone_infil)
"Yi" = (
/obj/machinery/door/airlock/hatch{
	id_tag = "lone_infil_bolt";
	name = "External Airlock";
	normalspeed = 0
	},
/obj/effect/mapping_helpers/airlock/access/all/syndicate/general,
/obj/docking_port/mobile/lone_infil{
	dir = 4
	},
/obj/structure/cable,
/obj/structure/fans/tiny,
/turf/open/floor/catwalk_floor/iron_dark,
/area/shuttle/lone_infil)
"YB" = (
/obj/machinery/camera/xray/directional/north{
	pixel_y = -32;
	network = list("lone_infil_shuttle");
	c_tag = "External View Starboard-Side"
	},
/turf/closed/wall/mineral/plastitanium,
/area/shuttle/lone_infil)
"YY" = (
/obj/structure/cable,
/obj/machinery/light/floor,
/obj/machinery/button/door/directional/west{
	id = "lone_infil_bolt";
	name = "External Bolt Control";
	normaldoorcontrol = 1;
	req_access = list("syndicate");
	specialfunctions = 4;
	pixel_y = 8
	},
/obj/machinery/button/door/directional/west{
	id = "lone_infil_shutter";
	name = "External Shutter Control";
	req_access = list("syndicate");
	pixel_y = -10
	},
/obj/structure/closet/generic/wall/empty{
	pixel_x = 32
	},
/obj/item/crowbar,
/turf/open/floor/mineral/plastitanium,
/area/shuttle/lone_infil)

(1,1,1) = {"
Jv
ie
nT
qu
Yi
qu
nT
ie
Jv
"}
(2,1,1) = {"
UZ
qu
qQ
tO
dc
YY
Nn
qu
UZ
"}
(3,1,1) = {"
qu
qu
qu
qu
qe
qu
Ve
qu
ie
"}
(4,1,1) = {"
qu
ie
vf
ie
Ve
ie
Jv
ie
qu
"}
(5,1,1) = {"
cZ
Jv
Jv
Jv
Jv
Jv
Jv
Jv
YB
"}
