//MAP CONVERTED BY dmm2tgm.py THIS HEADER COMMENT PREVENTS RECONVERSION, DO NOT REMOVE
"cz" = (
/obj/machinery/light/floor,
/turf/open/floor/mineral/titanium/white,
/area/shuttle/pirate/sapper)
"dZ" = (
/obj/machinery/atmospherics/components/unary/vent_pump/on{
	dir = 8;
	piping_layer = 4
	},
/turf/open/floor/mineral/titanium/white,
/area/shuttle/pirate/sapper)
"fn" = (
/obj/structure/cable,
/obj/machinery/door/poddoor/shutters/window{
	id = "pirate_sapper_shutter_L";
	dir = 8
	},
/obj/structure/fans/tiny/forcefield{
	dir = 4
	},
/turf/open/floor/plating,
/area/shuttle/pirate/sapper)
"fK" = (
/obj/structure/chair/comfy/shuttle{
	dir = 1
	},
/turf/open/floor/mineral/titanium/white,
/area/shuttle/pirate/sapper)
"fP" = (
/obj/structure/cable/layer1,
/obj/structure/rack,
/obj/machinery/light/floor,
/obj/machinery/power/terminal{
	dir = 4
	},
/obj/item/stack/sheet/mineral/plasma/five,
/obj/effect/decal/cleanable/plasma,
/turf/open/floor/plating,
/area/shuttle/pirate/sapper)
"hQ" = (
/obj/machinery/porta_turret/syndicate/energy/sapper{
	dir = 8
	},
/turf/closed/wall/mineral/titanium,
/area/shuttle/pirate/sapper)
"hV" = (
/obj/structure/cable/layer1,
/obj/machinery/atmospherics/pipe/smart/manifold4w/supply/hidden/layer4,
/turf/open/floor/catwalk_floor/flat_white,
/area/shuttle/pirate/sapper)
"jZ" = (
/obj/effect/decal/cleanable/wrapping,
/turf/open/floor/catwalk_floor/flat_white,
/area/shuttle/pirate/sapper)
"lZ" = (
/obj/machinery/light/floor,
/obj/effect/decal/cleanable/robot_debris/limb,
/turf/open/floor/mineral/titanium/white,
/area/shuttle/pirate/sapper)
"mE" = (
/obj/machinery/button/door/directional/north{
	id = "pirate_sapper_shutter_L"
	},
/turf/open/floor/catwalk_floor/flat_white,
/area/shuttle/pirate/sapper)
"mL" = (
/obj/structure/cable/layer1,
/obj/machinery/space_heater,
/obj/effect/decal/cleanable/shreds,
/turf/open/floor/plating,
/area/shuttle/pirate/sapper)
"mY" = (
/turf/closed/wall/mineral/titanium/overspace,
/area/shuttle/pirate/sapper)
"nt" = (
/obj/machinery/rnd/production/colony_lathe,
/obj/structure/sign/poster/contraband/rebels_unite/directional/north,
/turf/open/floor/mineral/titanium/white,
/area/shuttle/pirate/sapper)
"nE" = (
/obj/machinery/button/door/directional/north{
	id = "pirate_sapper_shutter_R"
	},
/obj/effect/decal/cleanable/ash,
/turf/open/floor/catwalk_floor/flat_white,
/area/shuttle/pirate/sapper)
"nM" = (
/obj/structure/cable,
/obj/docking_port/stationary{
	dwidth = 11;
	height = 16;
	shuttle_id = "pirate_home";
	name = "Deep Space";
	width = 17;
	dir = 4
	},
/obj/docking_port/mobile/pirate{
	launch_status = 0;
	movement_force = list("KNOCKDOWN"=0,"THROW"=0);
	name = "Pirate Ship";
	port_direction = 2;
	dir = 4
	},
/obj/machinery/door/poddoor/shutters/window{
	id = "pirate_sapper_shutter_R";
	dir = 4
	},
/obj/structure/fans/tiny/forcefield{
	dir = 4
	},
/turf/open/floor/plating,
/area/shuttle/pirate/sapper)
"pt" = (
/obj/structure/cable/layer1,
/obj/machinery/light/cold/directional/east,
/obj/machinery/atmospherics/pipe/smart/manifold4w/supply/visible/layer4,
/obj/structure/sign/warning/directional/south,
/obj/structure/table/reinforced,
/obj/machinery/microwave/engineering/cell_included,
/turf/open/floor/catwalk_floor/flat_white,
/area/shuttle/pirate/sapper)
"pH" = (
/obj/item/rcd_ammo/large{
	pixel_x = 8
	},
/obj/item/rcd_ammo/large{
	pixel_x = -3;
	pixel_y = -4
	},
/obj/item/rcd_ammo/large{
	pixel_x = -9;
	pixel_y = 9
	},
/obj/effect/decal/cleanable/oil,
/turf/open/floor/mineral/titanium/white,
/area/shuttle/pirate/sapper)
"qq" = (
/obj/structure/table/reinforced,
/obj/machinery/turretid{
	icon_state = "control_kill";
	lethal = 1;
	locked = 0;
	req_access = null;
	pixel_y = 4;
	pixel_x = -1
	},
/turf/open/floor/mineral/titanium/white,
/area/shuttle/pirate/sapper)
"qL" = (
/obj/machinery/computer/shuttle/pirate/sapper,
/obj/machinery/light/floor,
/obj/structure/cable/layer1,
/turf/open/floor/mineral/titanium/white,
/area/shuttle/pirate/sapper)
"sr" = (
/obj/machinery/computer/monitor,
/turf/open/floor/mineral/titanium/white,
/area/shuttle/pirate/sapper)
"tM" = (
/obj/structure/cable/layer1,
/obj/machinery/atmospherics/components/tank/air{
	piping_layer = 4
	},
/turf/open/floor/plating,
/area/shuttle/pirate/sapper)
"ua" = (
/obj/structure/chair/comfy/shuttle{
	dir = 1
	},
/obj/structure/cable/layer1,
/turf/open/floor/mineral/titanium/white,
/area/shuttle/pirate/sapper)
"uz" = (
/obj/structure/window/reinforced/spawner/directional/north{
	pixel_y = 1
	},
/obj/machinery/power/shuttle_engine/heater,
/obj/effect/turf_decal/stripes/line{
	dir = 8
	},
/turf/open/floor/plating/airless,
/area/shuttle/pirate/sapper)
"uD" = (
/obj/effect/mob_spawn/ghost_role/human/sapper,
/obj/effect/decal/cleanable/oil,
/turf/open/floor/mineral/titanium/white,
/area/shuttle/pirate/sapper)
"vB" = (
/obj/machinery/power/port_gen/pacman{
	anchored = 1;
	cable_layer = 1
	},
/obj/structure/cable/layer1,
/turf/open/floor/plating,
/area/shuttle/pirate/sapper)
"wf" = (
/obj/machinery/computer/camera_advanced/shuttle_docker/syndicate/pirate/sapper,
/turf/open/floor/mineral/titanium/white,
/area/shuttle/pirate/sapper)
"xf" = (
/obj/item/stack/sheet/iron/twenty,
/obj/item/stack/sheet/glass{
	amount = 20
	},
/obj/item/stack/sheet/plastic/five,
/obj/item/stack/sheet/mineral/titanium{
	amount = 5
	},
/obj/item/stack/sheet/mineral/gold{
	amount = 5
	},
/obj/machinery/ore_silo/colony_lathe,
/obj/item/stack/sheet/mineral/silver{
	amount = 5
	},
/obj/structure/sign/poster/contraband/power/directional/north,
/turf/open/floor/mineral/titanium/white,
/area/shuttle/pirate/sapper)
"xA" = (
/turf/open/floor/catwalk_floor/flat_white,
/area/shuttle/pirate/sapper)
"yt" = (
/obj/machinery/light/floor,
/obj/effect/decal/cleanable/plastic,
/turf/open/floor/mineral/titanium/white,
/area/shuttle/pirate/sapper)
"yx" = (
/obj/structure/window/reinforced/spawner/directional/north{
	pixel_y = 1
	},
/obj/machinery/power/shuttle_engine/heater,
/turf/open/floor/plating/airless,
/area/shuttle/pirate/sapper)
"yE" = (
/turf/closed/wall/mineral/titanium,
/area/shuttle/pirate/sapper)
"Bp" = (
/obj/structure/table/reinforced,
/obj/machinery/button/door/directional{
	id = "pirate_sapper_shutter";
	pixel_x = 6
	},
/obj/machinery/recharger{
	pixel_x = -6;
	pixel_y = 3
	},
/turf/open/floor/mineral/titanium/white,
/area/shuttle/pirate/sapper)
"BT" = (
/obj/machinery/power/smes/ship{
	cable_layer = 1
	},
/obj/structure/cable/layer1,
/turf/open/floor/plating,
/area/shuttle/pirate/sapper)
"Dl" = (
/obj/machinery/door/poddoor/shutters{
	id = "pirate_sapper_shutter_L";
	dir = 8
	},
/obj/structure/fans/tiny/forcefield{
	dir = 4
	},
/turf/open/floor/plating,
/area/shuttle/pirate/sapper)
"DZ" = (
/obj/machinery/atmospherics/components/unary/vent_pump/on{
	dir = 4;
	piping_layer = 4
	},
/turf/open/floor/mineral/titanium/white,
/area/shuttle/pirate/sapper)
"EE" = (
/obj/structure/cable/layer1,
/obj/machinery/airalarm/directional/east{
	locked = 0
	},
/obj/machinery/atmospherics/pipe/smart/manifold4w/supply/hidden/layer4,
/obj/structure/table/reinforced,
/obj/effect/spawner/random/food_or_drink/donkpockets,
/turf/open/floor/catwalk_floor/flat_white,
/area/shuttle/pirate/sapper)
"Ih" = (
/turf/closed/wall/mineral/titanium/nodiagonal,
/area/shuttle/pirate/sapper)
"In" = (
/obj/machinery/power/shuttle_engine/propulsion,
/obj/effect/turf_decal/stripes/line,
/turf/open/floor/plating/airless,
/area/shuttle/pirate/sapper)
"Mi" = (
/obj/machinery/power/shuttle_engine/propulsion,
/obj/effect/turf_decal/stripes/line{
	dir = 10
	},
/turf/open/floor/plating/airless,
/area/shuttle/pirate/sapper)
"Ml" = (
/obj/structure/cable/layer1,
/obj/machinery/power/apc/auto_name/directional/west{
	cable_layer = 1;
	locked = 0
	},
/obj/structure/closet/crate/engineering,
/obj/item/pipe_dispenser,
/obj/item/pipe_dispenser,
/obj/item/rpd_upgrade/unwrench,
/obj/item/rpd_upgrade/unwrench,
/turf/open/floor/catwalk_floor/flat_white,
/area/shuttle/pirate/sapper)
"NX" = (
/obj/structure/window/reinforced/spawner/directional/north{
	pixel_y = 1
	},
/obj/machinery/power/shuttle_engine/heater,
/obj/effect/turf_decal/stripes/line{
	dir = 4
	},
/turf/open/floor/plating/airless,
/area/shuttle/pirate/sapper)
"Oc" = (
/obj/structure/cable/layer1,
/obj/machinery/atmospherics/pipe/smart/manifold4w/supply/hidden/layer4,
/obj/item/storage/pouch/material,
/obj/item/stack/sheet/mineral/sandbags{
	amount = 15
	},
/obj/structure/closet{
	icon_state = "eng";
	icon_door = "eng_tool"
	},
/obj/item/stack/sheet/plasteel/twenty,
/obj/item/stack/sheet/iron/twenty,
/obj/item/stack/sheet/rglass{
	amount = 20
	},
/obj/item/holosign_creator/atmos,
/turf/open/floor/catwalk_floor/flat_white,
/area/shuttle/pirate/sapper)
"Sa" = (
/obj/structure/cable,
/turf/open/floor/catwalk_floor/flat_white,
/area/shuttle/pirate/sapper)
"SP" = (
/obj/machinery/porta_turret/syndicate/energy/sapper{
	dir = 4
	},
/turf/closed/wall/mineral/titanium,
/area/shuttle/pirate/sapper)
"Tb" = (
/obj/machinery/power/shuttle_engine/propulsion,
/obj/effect/turf_decal/stripes/line{
	dir = 6
	},
/turf/open/floor/plating/airless,
/area/shuttle/pirate/sapper)
"Tx" = (
/obj/machinery/door/poddoor/shutters{
	id = "pirate_sapper_shutter_R";
	dir = 4
	},
/obj/structure/fans/tiny/forcefield{
	dir = 4
	},
/turf/open/floor/plating,
/area/shuttle/pirate/sapper)
"TF" = (
/obj/effect/decal/cleanable/robot_debris/up,
/turf/open/floor/mineral/titanium/white,
/area/shuttle/pirate/sapper)
"Vt" = (
/obj/structure/cable,
/obj/item/powersink/creditminer,
/obj/machinery/piratepad/sapper,
/turf/open/floor/plating,
/area/shuttle/pirate/sapper)
"Wo" = (
/obj/effect/mob_spawn/ghost_role/human/sapper,
/turf/open/floor/mineral/titanium/white,
/area/shuttle/pirate/sapper)
"WY" = (
/obj/machinery/computer/piratepad_control/sapper,
/turf/open/floor/catwalk_floor/flat_white,
/area/shuttle/pirate/sapper)
"Xc" = (
/obj/structure/cable/layer1,
/obj/machinery/atmospherics/pipe/smart/manifold4w/supply/hidden/layer4,
/obj/effect/decal/cleanable/plastic,
/turf/open/floor/catwalk_floor/flat_white,
/area/shuttle/pirate/sapper)
"Xr" = (
/obj/structure/cable/layer1,
/obj/machinery/light/cold/directional/west,
/obj/structure/closet/crate/engineering/electrical,
/obj/item/stack/cable_coil/thirty,
/obj/item/stack/cable_coil/thirty,
/obj/item/stack/cable_coil/thirty,
/obj/item/stack/cable_coil/thirty,
/obj/structure/sign/warning/directional/south,
/turf/open/floor/catwalk_floor/flat_white,
/area/shuttle/pirate/sapper)
"XX" = (
/obj/effect/spawner/structure/window/reinforced/shuttle,
/obj/machinery/door/poddoor/shutters/preopen{
	id = "pirate_sapper_shutter"
	},
/obj/structure/cable/layer1,
/turf/open/floor/plating,
/area/shuttle/pirate/sapper)
"Yx" = (
/turf/open/space/basic,
/area/template_noop)
"Zc" = (
/obj/structure/cable/layer1,
/obj/structure/cable,
/obj/machinery/atmospherics/pipe/smart/manifold4w/supply/hidden/layer4,
/turf/open/floor/catwalk_floor/flat_white,
/area/shuttle/pirate/sapper)

(1,1,1) = {"
Yx
Yx
Yx
mY
Dl
fn
Dl
mY
Yx
Yx
Yx
"}
(2,1,1) = {"
Yx
yE
hQ
Ih
mE
Sa
xA
Ih
hQ
yE
Yx
"}
(3,1,1) = {"
yE
Ih
nt
Oc
hV
Zc
hV
Ml
Xr
Ih
mY
"}
(4,1,1) = {"
XX
wf
fK
hV
TF
Sa
dZ
jZ
mL
uz
Mi
"}
(5,1,1) = {"
XX
Bp
uD
hV
cz
Sa
yt
xA
vB
yx
In
"}
(6,1,1) = {"
XX
qL
ua
hV
xA
Vt
WY
xA
fP
yx
In
"}
(7,1,1) = {"
XX
qq
Wo
hV
lZ
Sa
cz
xA
BT
yx
In
"}
(8,1,1) = {"
XX
sr
fK
Xc
DZ
Sa
pH
xA
tM
NX
Tb
"}
(9,1,1) = {"
yE
Ih
xf
Oc
hV
Zc
hV
EE
pt
Ih
mY
"}
(10,1,1) = {"
Yx
yE
SP
Ih
nE
Sa
xA
Ih
SP
yE
Yx
"}
(11,1,1) = {"
Yx
Yx
Yx
mY
Tx
nM
Tx
mY
Yx
Yx
Yx
"}
