//MAP CONVERTED BY dmm2tgm.py THIS HEADER COMMENT PREVENTS RECONVERSION, DO NOT REMOVE
"af" = (
/obj/structure/grille,
/obj/structure/window/reinforced/shuttle/spaceship,
/turf/open/floor/plating,
/area/space)
"aO" = (
/obj/machinery/door/airlock/vault,
/turf/open/floor/pod/dark,
/area/space)
"aW" = (
/obj/structure/window/reinforced/survival_pod/spawner/directional/south,
/turf/open/floor/carpet/black,
/area/space)
"bq" = (
/obj/machinery/door/window/survival_pod{
	dir = 8
	},
/turf/open/floor/pod/dark,
/area/space)
"bt" = (
/turf/open/floor/pod,
/area/space)
"bv" = (
/obj/structure/table,
/obj/structure/bedsheetbin,
/turf/open/floor/pod,
/area/space)
"bH" = (
/obj/machinery/washing_machine,
/turf/open/floor/pod,
/area/space)
"bN" = (
/obj/structure/rack,
/turf/open/floor/pod/dark,
/area/space)
"cn" = (
/obj/structure/sink/directional/north,
/obj/structure/mirror/directional/south,
/turf/open/floor/iron/white,
/area/space)
"cq" = (
/obj/structure/chair/office{
	dir = 8
	},
/turf/open/floor/carpet/black,
/area/space)
"cB" = (
/obj/structure/toilet{
	dir = 4
	},
/turf/open/floor/iron/white,
/area/space)
"cX" = (
/obj/structure/table,
/obj/machinery/coffeemaker{
	pixel_x = 0;
	pixel_y = 8
	},
/turf/open/floor/pod/dark,
/area/space)
"dE" = (
/obj/structure/table,
/obj/item/storage/fancy/donut_box,
/turf/open/floor/pod/dark,
/area/space)
"dF" = (
/obj/machinery/suit_storage_unit/hc_police,
/obj/structure/window/reinforced/survival_pod/spawner/directional/north,
/turf/open/floor/pod/dark,
/area/space)
"ez" = (
/obj/structure/window/reinforced/survival_pod/spawner/directional/north,
/obj/structure/chair/office{
	dir = 8
	},
/turf/open/floor/pod/light,
/area/space)
"fv" = (
/obj/structure/table,
/obj/structure/window/reinforced/survival_pod/spawner/directional/west,
/turf/open/floor/pod/light,
/area/space)
"gi" = (
/obj/structure/window/reinforced/survival_pod/spawner/directional/west,
/obj/machinery/suit_storage_unit/hc_police,
/turf/open/floor/pod/dark,
/area/space)
"gn" = (
/obj/effect/spawner/random/structure/closet_private,
/turf/open/floor/wood,
/area/space)
"gs" = (
/obj/machinery/door/airlock/titanium,
/turf/open/floor/iron/white,
/area/space)
"gG" = (
/obj/machinery/door/window/survival_pod/left/directional/east,
/obj/structure/window/reinforced/survival_pod/spawner/directional/south,
/turf/open/floor/pod/dark,
/area/space)
"ib" = (
/obj/machinery/power/port_gen/pacman/solid_fuel,
/turf/open/floor/pod/dark,
/area/space)
"iP" = (
/turf/template_noop,
/area/space)
"jC" = (
/obj/structure/sink/directional/east,
/obj/machinery/dryer{
	pixel_x = 0;
	pixel_y = -32
	},
/obj/structure/mirror/directional/west,
/turf/open/floor/iron/white,
/area/space)
"jF" = (
/obj/structure/table,
/obj/structure/window/reinforced/survival_pod/spawner/directional/east,
/turf/open/floor/pod/light,
/area/space)
"lH" = (
/obj/machinery/shower/directional/north,
/obj/structure/window/reinforced/survival_pod/spawner/directional/west,
/obj/structure/drain,
/obj/structure/curtain,
/turf/open/floor/iron/white,
/area/space)
"lI" = (
/obj/structure/chair/office{
	dir = 4
	},
/turf/open/floor/carpet/black,
/area/space)
"mm" = (
/turf/open/floor/pod/dark,
/area/space)
"mH" = (
/turf/open/floor/iron/showroomfloor,
/area/space)
"mI" = (
/obj/structure/window/reinforced/plasma/spawner/directional/west,
/obj/structure/window/reinforced/plasma/spawner/directional/north,
/turf/open/floor/engine/air,
/area/space)
"mN" = (
/obj/structure/window/reinforced/survival_pod/spawner/directional/north,
/obj/structure/closet/crate/bin,
/turf/open/floor/pod/light,
/area/space)
"of" = (
/obj/machinery/vending/deforest_medvend,
/turf/open/floor/pod/dark,
/area/space)
"oF" = (
/turf/open/floor/carpet/black,
/area/space)
"oK" = (
/obj/structure/closet/emcloset,
/turf/open/floor/plating,
/area/space)
"qj" = (
/obj/machinery/ammo_workbench/unlocked,
/turf/open/floor/pod/dark,
/area/space)
"qW" = (
/obj/machinery/door/window/survival_pod,
/turf/open/floor/carpet/black,
/area/space)
"rb" = (
/obj/structure/table,
/obj/structure/window/reinforced/survival_pod/spawner/directional/west,
/obj/structure/window/reinforced/survival_pod/spawner/directional/south,
/obj/item/modular_computer/laptop/preset/civilian,
/turf/open/floor/pod/light,
/area/space)
"ri" = (
/obj/structure/bed{
	dir = 1
	},
/turf/open/floor/carpet/royalblue,
/area/space)
"sd" = (
/obj/machinery/door/window/survival_pod/left/directional/west,
/turf/open/floor/pod/light,
/area/space)
"sU" = (
/obj/effect/spawner/random/structure/closet_private,
/turf/open/floor/carpet/royalblue,
/area/space)
"uD" = (
/obj/structure/table,
/obj/machinery/microwave{
	pixel_x = 0;
	pixel_y = 7
	},
/turf/open/floor/iron/kitchen,
/area/space)
"uS" = (
/obj/machinery/door/window/survival_pod{
	dir = 4
	},
/turf/open/floor/pod/dark,
/area/space)
"vh" = (
/obj/structure/window/reinforced/survival_pod/spawner/directional/north,
/obj/structure/chair/office{
	dir = 4
	},
/turf/open/floor/pod/light,
/area/space)
"vF" = (
/obj/structure/chair{
	dir = 4
	},
/turf/open/floor/iron/kitchen,
/area/space)
"wb" = (
/obj/structure/window/reinforced/survival_pod/spawner/directional/south,
/obj/structure/chair/office{
	dir = 4
	},
/turf/open/floor/pod/light,
/area/space)
"wl" = (
/obj/machinery/door/window/survival_pod/left/directional/east,
/obj/structure/window/reinforced/survival_pod/spawner/directional/north,
/turf/open/floor/pod/dark,
/area/space)
"wO" = (
/obj/machinery/vending/security/noaccess,
/turf/open/floor/pod/dark,
/area/space)
"xd" = (
/obj/structure/chair{
	dir = 8
	},
/turf/open/floor/iron/kitchen,
/area/space)
"xB" = (
/obj/structure/table/wood,
/turf/open/floor/wood,
/area/space)
"yo" = (
/obj/structure/chair/office,
/turf/open/floor/carpet/black,
/area/space)
"yH" = (
/obj/structure/window/reinforced/survival_pod/spawner/directional/west,
/obj/structure/closet/secure_closet/armory_kiboko,
/turf/open/floor/pod/dark,
/area/space)
"zZ" = (
/obj/structure/window/reinforced/survival_pod/spawner/directional/north,
/turf/open/floor/pod/dark,
/area/space)
"Aj" = (
/turf/open/floor/carpet/royalblue,
/area/space)
"Bu" = (
/obj/machinery/door/airlock/survival_pod{
	dir = 4
	},
/turf/open/floor/plating,
/area/space)
"CA" = (
/obj/structure/window/reinforced/survival_pod/spawner/directional/south,
/obj/structure/chair/office{
	dir = 8
	},
/turf/open/floor/pod/light,
/area/space)
"CJ" = (
/obj/structure/window/reinforced/plasma/spawner/directional/west,
/obj/structure/window/reinforced/plasma/spawner/directional/south,
/turf/open/floor/engine/air,
/area/space)
"CO" = (
/obj/structure/closet/firecloset,
/turf/open/floor/plating,
/area/space)
"Db" = (
/obj/structure/window/reinforced/survival_pod/spawner/directional/south,
/obj/structure/closet/crate/bin,
/turf/open/floor/pod/light,
/area/space)
"Dl" = (
/obj/machinery/power/smes/super/full,
/turf/open/floor/pod/dark,
/area/space)
"DE" = (
/obj/structure/table/reinforced/plastitaniumglass,
/turf/open/floor/carpet/black,
/area/space)
"DK" = (
/obj/structure/table,
/obj/structure/window/reinforced/survival_pod/spawner/directional/east,
/obj/structure/window/reinforced/survival_pod/spawner/directional/south,
/obj/item/modular_computer/laptop/preset/civilian,
/turf/open/floor/pod/light,
/area/space)
"DM" = (
/turf/open/floor/plating,
/area/space)
"Er" = (
/obj/structure/window/reinforced/survival_pod/spawner/directional/east,
/turf/open/floor/carpet/black,
/area/space)
"Ez" = (
/obj/structure/table/optable,
/turf/open/floor/iron/showroomfloor,
/area/space)
"Fg" = (
/obj/structure/rack/shelf,
/turf/open/floor/pod/dark,
/area/space)
"Fl" = (
/turf/open/floor/pod/light,
/area/space)
"Gb" = (
/turf/open/floor/iron/kitchen,
/area/space)
"Gu" = (
/obj/machinery/door/airlock/survival_pod,
/turf/open/floor/plating,
/area/space)
"GE" = (
/obj/structure/table/reinforced,
/obj/machinery/recharger{
	pixel_x = -4;
	pixel_y = 5
	},
/obj/machinery/recharger{
	pixel_x = 5;
	pixel_y = 5
	},
/turf/open/floor/pod/dark,
/area/space)
"GT" = (
/obj/structure/rack/gunrack,
/turf/open/floor/pod/dark,
/area/space)
"HH" = (
/obj/machinery/dish_drive/bullet,
/turf/open/floor/pod/dark,
/area/space)
"Ip" = (
/obj/machinery/power/smes/connector,
/turf/open/floor/pod/dark,
/area/space)
"IU" = (
/obj/structure/closet/secure_closet/tac,
/turf/open/floor/pod/dark,
/area/space)
"JG" = (
/obj/structure/closet/secure_closet/freezer/fridge/all_access,
/turf/open/floor/iron/kitchen,
/area/space)
"Kb" = (
/obj/structure/table,
/turf/open/floor/carpet/royalblue,
/area/space)
"MQ" = (
/obj/machinery/power/micro_reactor/bapgm,
/turf/open/floor/pod/dark,
/area/space)
"Nj" = (
/obj/structure/table/wood,
/turf/open/floor/carpet/royalblue,
/area/space)
"NX" = (
/obj/structure/table/reinforced/plastitaniumglass,
/obj/item/storage/fancy/donut_box,
/turf/open/floor/carpet/black,
/area/space)
"Od" = (
/obj/structure/window/reinforced/survival_pod/spawner/directional/east,
/obj/structure/window/reinforced/survival_pod/spawner/directional/south,
/turf/open/floor/carpet/black,
/area/space)
"OC" = (
/obj/machinery/suit_storage_unit/hc_police,
/turf/open/floor/pod/dark,
/area/space)
"OO" = (
/obj/structure/table,
/obj/structure/towel_bin,
/turf/open/floor/iron/white,
/area/space)
"PL" = (
/obj/structure/reagent_dispensers/water_cooler,
/turf/open/floor/pod/dark,
/area/space)
"Qf" = (
/obj/machinery/biogenerator/food_replicator,
/turf/open/floor/iron/kitchen,
/area/space)
"Qv" = (
/obj/structure/window/reinforced/plasma/spawner/directional/south,
/obj/structure/window/reinforced/plasma/spawner/directional/east,
/turf/open/floor/engine/air,
/area/space)
"QF" = (
/obj/machinery/suit_storage_unit/hc_police,
/obj/structure/window/reinforced/survival_pod/spawner/directional/north,
/obj/structure/window/reinforced/survival_pod/spawner/directional/west,
/turf/open/floor/pod/dark,
/area/space)
"QN" = (
/obj/structure/window/reinforced/plasma/spawner/directional/north,
/obj/structure/window/reinforced/plasma/spawner/directional/east,
/turf/open/floor/engine/air,
/area/space)
"Rf" = (
/obj/structure/noticeboard/directional/north,
/obj/structure/chair/office,
/turf/open/floor/carpet/black,
/area/space)
"Rx" = (
/turf/closed/wall/mineral/titanium/spaceship/nodiagonal,
/area/space)
"RW" = (
/obj/machinery/smesbank,
/turf/open/floor/pod/dark,
/area/space)
"RX" = (
/obj/structure/table,
/obj/structure/window/reinforced/survival_pod/spawner/directional/north,
/obj/structure/window/reinforced/survival_pod/spawner/directional/west,
/obj/item/modular_computer/laptop/preset/civilian,
/turf/open/floor/pod/light,
/area/space)
"SC" = (
/obj/machinery/door/window/survival_pod/left/directional/east,
/turf/open/floor/pod/light,
/area/space)
"Tf" = (
/turf/open/floor/iron/white,
/area/space)
"Ti" = (
/obj/machinery/shower/directional/north,
/obj/structure/window/reinforced/survival_pod/spawner/directional/east,
/obj/structure/drain,
/obj/structure/curtain,
/turf/open/floor/iron/white,
/area/space)
"Tt" = (
/obj/structure/window/reinforced/survival_pod/spawner/directional/south,
/turf/open/floor/pod/dark,
/area/space)
"Ui" = (
/turf/open/floor/wood,
/area/space)
"Um" = (
/turf/open/floor/engine,
/area/space)
"VQ" = (
/obj/structure/table,
/turf/open/floor/iron/kitchen,
/area/space)
"VR" = (
/obj/machinery/door/airlock/survival_pod{
	dir = 1
	},
/turf/open/floor/plating,
/area/space)
"YX" = (
/obj/structure/table,
/obj/structure/window/reinforced/survival_pod/spawner/directional/north,
/obj/structure/window/reinforced/survival_pod/spawner/directional/east,
/obj/item/modular_computer/laptop/preset/civilian,
/turf/open/floor/pod/light,
/area/space)
"ZB" = (
/obj/structure/bed{
	dir = 1
	},
/obj/item/bedsheet{
	dir = 1
	},
/turf/open/floor/wood,
/area/space)
"ZO" = (
/obj/structure/toilet,
/turf/open/floor/iron/white,
/area/space)

(1,1,1) = {"
iP
iP
Rx
Rx
Rx
Rx
Rx
Rx
Rx
Rx
Rx
Rx
Rx
Rx
Rx
Rx
Rx
Rx
Rx
Rx
Rx
Rx
Rx
Rx
Rx
Rx
Rx
Rx
Rx
iP
iP
iP
iP
iP
iP
iP
"}
(2,1,1) = {"
iP
iP
Rx
ri
Aj
sU
Rx
ZO
Tf
cn
Rx
xB
ZB
Rx
xB
ZB
Rx
xB
ZB
Rx
xB
ZB
Rx
xB
ZB
Rx
cB
jC
Rx
iP
iP
iP
iP
iP
iP
iP
"}
(3,1,1) = {"
iP
iP
Rx
Nj
Aj
Aj
gs
Tf
Tf
Tf
Rx
gn
Ui
Rx
gn
Ui
Rx
gn
Ui
Rx
gn
Ui
Rx
gn
Ui
Rx
gs
Rx
Rx
iP
iP
iP
iP
iP
iP
iP
"}
(4,1,1) = {"
Rx
Rx
Rx
Rx
Rx
Aj
Rx
Rx
Rx
Rx
Rx
Rx
Ui
Rx
Rx
Ui
Rx
Rx
Ui
Rx
Rx
Ui
Rx
Rx
Ui
Rx
Tf
Ti
Rx
Rx
Rx
Rx
Rx
Rx
iP
iP
"}
(5,1,1) = {"
Rx
Kb
Aj
Aj
Aj
Aj
Aj
Aj
Aj
Rx
bv
bt
bt
bt
bt
bt
bt
bt
bt
bt
bt
bt
bt
bt
bt
Rx
Tf
OO
Rx
ib
Tt
zZ
MQ
Rx
iP
iP
"}
(6,1,1) = {"
Rx
Kb
Aj
Aj
Aj
Aj
Aj
Aj
Aj
Rx
bH
bt
bt
bt
bt
bt
bt
bt
bt
bt
bt
bt
bt
bt
bt
gs
Tf
lH
Rx
Rx
gG
wl
Rx
Rx
iP
iP
"}
(7,1,1) = {"
Rx
Rx
Rx
af
af
af
Rx
af
Aj
Rx
Rx
af
af
Rx
Rx
af
af
Rx
Rx
Rx
bt
bt
Rx
Rx
Rx
Rx
Rx
Rx
Rx
Dl
mm
mm
RW
Rx
iP
iP
"}
(8,1,1) = {"
iP
iP
Rx
oF
oF
lI
aW
bt
bt
Rx
JG
Qf
uD
Rx
bt
bt
bt
bt
bt
bt
bt
bt
bt
bt
bt
bt
bt
bt
Rx
mm
mm
mm
Ip
Rx
iP
iP
"}
(9,1,1) = {"
iP
iP
Rx
yo
DE
DE
aW
bt
bt
af
Gb
Gb
Gb
Rx
bt
bt
bt
bt
bt
bt
bt
bt
bt
bt
bt
bt
bt
bt
Rx
Dl
mm
mm
RW
Rx
iP
iP
"}
(10,1,1) = {"
iP
iP
Rx
Rf
NX
DE
qW
bt
bt
af
vF
vF
Gb
Rx
bt
bt
Rx
Rx
Rx
Rx
Fl
Fl
Rx
Rx
Rx
Rx
bt
bt
Rx
mm
mm
mm
mm
Rx
Rx
Rx
"}
(11,1,1) = {"
iP
iP
Rx
yo
DE
DE
qW
bt
bt
af
VQ
VQ
Gb
Gb
bt
bt
Rx
Fl
Fl
Db
Fl
Fl
mN
Fl
Fl
Rx
bt
bt
Rx
mm
mm
mm
mm
Rx
iP
iP
"}
(12,1,1) = {"
iP
iP
Rx
oF
cq
cq
aW
bt
bt
Rx
xd
xd
Gb
Gb
bt
bt
Rx
Fl
Fl
wb
Fl
Fl
vh
Fl
Fl
Rx
bt
bt
Rx
af
mm
mm
af
Rx
iP
iP
"}
(13,1,1) = {"
iP
iP
Rx
Er
Er
Er
Od
bt
bt
Rx
af
af
af
Rx
bt
bt
Rx
SC
jF
DK
Fl
Fl
YX
jF
SC
Rx
bt
bt
Rx
mm
mm
mm
mm
Rx
iP
iP
"}
(14,1,1) = {"
iP
iP
Rx
bt
bt
bt
bt
bt
bt
bt
bt
bt
bt
bt
bt
bt
Fl
Fl
Fl
Fl
Fl
Fl
Fl
Fl
Fl
af
bt
bt
mm
mm
mm
mm
mm
Rx
iP
iP
"}
(15,1,1) = {"
iP
iP
Rx
bt
bt
bt
bt
bt
bt
bt
bt
bt
bt
bt
bt
bt
Fl
Fl
Fl
Fl
Fl
Fl
Fl
Fl
Fl
af
bt
bt
mm
mm
mm
mm
mm
Rx
iP
iP
"}
(16,1,1) = {"
iP
iP
Rx
aO
aO
Rx
dE
cX
PL
Rx
Rx
Rx
Rx
Rx
bt
bt
Rx
sd
fv
rb
Fl
Fl
RX
fv
sd
Rx
bt
bt
Rx
mm
mm
mm
mm
Rx
iP
iP
"}
(17,1,1) = {"
iP
Rx
Rx
uS
uS
Rx
Rx
Rx
Rx
Rx
mH
Ez
mH
Rx
bt
bt
Rx
Fl
Fl
CA
Fl
Fl
ez
Fl
Fl
Rx
bt
bt
Rx
af
mm
mm
af
Rx
iP
iP
"}
(18,1,1) = {"
iP
Rx
GE
mm
mm
mm
mm
mm
wO
Rx
mH
mH
mH
Rx
bt
bt
Rx
Fl
Fl
Db
Fl
Fl
mN
Fl
Fl
Rx
bt
bt
Rx
mm
mm
mm
mm
Rx
iP
iP
"}
(19,1,1) = {"
iP
Rx
HH
mm
mm
mm
mm
mm
of
Rx
mH
mH
mH
Rx
bt
bt
Rx
Rx
Rx
Rx
af
af
Rx
Rx
Rx
Rx
bt
bt
Rx
mm
mI
CJ
mm
Rx
iP
iP
"}
(20,1,1) = {"
iP
Rx
qj
mm
mm
mm
QF
bq
yH
Rx
mH
mH
mH
mH
bt
bt
bt
bt
bt
bt
bt
bt
bt
bt
bt
bt
bt
bt
Rx
mm
QN
Qv
mm
Rx
Rx
Rx
"}
(21,1,1) = {"
iP
Rx
Rx
GE
qj
HH
dF
mm
IU
Rx
mH
mH
mH
mH
bt
bt
bt
bt
bt
bt
bt
bt
bt
bt
bt
bt
bt
bt
Rx
mm
mm
mm
mm
Rx
iP
iP
"}
(22,1,1) = {"
iP
iP
Rx
gi
gi
gi
OC
mm
Rx
Rx
Rx
Bu
Bu
Rx
Rx
Rx
Rx
Rx
Rx
Rx
Bu
Bu
Rx
Rx
Rx
Rx
Rx
Rx
Rx
mm
mI
CJ
mm
Rx
iP
iP
"}
(23,1,1) = {"
iP
iP
Rx
mm
mm
mm
mm
mm
Rx
iP
Rx
DM
DM
Gu
Um
Um
Um
Um
Um
VR
DM
DM
Rx
iP
iP
iP
iP
iP
Rx
mm
QN
Qv
mm
Rx
iP
iP
"}
(24,1,1) = {"
iP
iP
Rx
mm
mm
mm
mm
mm
Rx
iP
Rx
DM
DM
Gu
Um
Um
Um
Um
Um
VR
DM
DM
Rx
iP
iP
iP
iP
iP
Rx
mm
mm
mm
mm
Rx
iP
iP
"}
(25,1,1) = {"
iP
iP
Rx
GT
GT
bN
Fg
Fg
Rx
iP
Rx
CO
oK
Rx
Um
Um
Um
Um
Um
Rx
oK
CO
Rx
iP
iP
iP
iP
iP
Rx
Rx
Rx
Rx
Rx
Rx
iP
iP
"}
(26,1,1) = {"
iP
iP
Rx
Rx
Rx
Rx
Rx
Rx
Rx
iP
Rx
Rx
Rx
Rx
iP
Um
Um
Um
iP
Rx
Rx
Rx
Rx
iP
iP
iP
iP
iP
iP
iP
iP
iP
iP
iP
iP
iP
"}
