//MAP CONVERTED BY dmm2tgm.py THIS HEADER COMMENT PREVENTS RECONVERSION, DO NOT REMOVE
"a" = (
/turf/open/floor/pod/light,
/area/space)
"e" = (
/obj/structure/table,
/obj/structure/window/reinforced/survival_pod/spawner/directional/east,
/obj/structure/window/reinforced/survival_pod/spawner/directional/south,
/turf/open/floor/pod/light,
/area/space)
"i" = (
/turf/open/floor/plating,
/area/space)
"j" = (
/turf/open/floor/pod/dark,
/area/space)
"k" = (
/obj/structure/grille,
/obj/structure/window/reinforced/shuttle/spaceship,
/turf/open/floor/plating,
/area/space)
"m" = (
/obj/structure/table,
/obj/structure/window/reinforced/survival_pod/spawner/directional/north,
/obj/structure/window/reinforced/survival_pod/spawner/directional/west,
/turf/open/floor/pod/light,
/area/space)
"w" = (
/obj/structure/table,
/obj/structure/window/reinforced/survival_pod/spawner/directional/west,
/turf/open/floor/pod/light,
/area/space)
"z" = (
/obj/structure/table,
/obj/structure/window/reinforced/survival_pod/spawner/directional/west,
/obj/structure/window/reinforced/survival_pod/spawner/directional/south,
/turf/open/floor/pod/light,
/area/space)
"A" = (
/obj/structure/table,
/obj/structure/window/reinforced/survival_pod/spawner/directional/north,
/obj/structure/window/reinforced/survival_pod/spawner/directional/east,
/turf/open/floor/pod/light,
/area/space)
"D" = (
/obj/structure/window/reinforced/survival_pod/spawner/directional/north,
/turf/open/floor/pod/light,
/area/space)
"E" = (
/obj/structure/window/reinforced/survival_pod/spawner/directional/south,
/turf/open/floor/pod/light,
/area/space)
"J" = (
/turf/template_noop,
/area/space)
"Q" = (
/turf/closed/wall/mineral/titanium/spaceship/nodiagonal,
/area/space)
"U" = (
/obj/structure/table,
/obj/structure/window/reinforced/survival_pod/spawner/directional/east,
/turf/open/floor/pod/light,
/area/space)

(1,1,1) = {"
J
J
J
J
J
J
J
J
J
J
Q
Q
Q
Q
Q
Q
Q
Q
Q
Q
Q
Q
Q
Q
Q
Q
J
J
J
J
J
J
J
J
J
J
"}
(2,1,1) = {"
J
J
J
J
J
J
J
J
J
J
Q
j
j
Q
j
j
Q
j
j
Q
j
j
Q
j
j
Q
J
J
J
J
J
J
J
J
J
J
"}
(3,1,1) = {"
J
J
J
J
J
J
J
J
J
J
Q
j
j
Q
j
j
Q
j
j
Q
j
j
Q
j
j
Q
J
J
J
J
J
J
J
J
J
J
"}
(4,1,1) = {"
J
J
J
J
J
J
J
J
J
Q
Q
Q
j
Q
Q
j
Q
Q
j
Q
Q
j
Q
Q
j
Q
Q
Q
Q
Q
Q
Q
Q
Q
J
J
"}
(5,1,1) = {"
J
J
J
J
J
J
J
J
J
Q
j
j
j
j
j
j
j
j
j
j
j
j
j
j
j
Q
j
j
Q
j
j
j
j
Q
J
J
"}
(6,1,1) = {"
J
J
J
J
J
J
J
J
J
Q
j
j
j
j
j
j
j
j
j
j
j
j
j
j
j
j
j
j
Q
j
j
j
j
Q
J
J
"}
(7,1,1) = {"
J
J
Q
Q
Q
Q
Q
Q
Q
Q
Q
k
k
Q
Q
k
k
Q
Q
Q
j
j
Q
Q
Q
Q
Q
Q
Q
j
j
j
j
Q
J
J
"}
(8,1,1) = {"
J
J
Q
J
J
J
J
J
J
Q
a
a
a
Q
j
j
j
j
j
j
j
j
j
j
j
j
j
j
Q
j
j
j
j
Q
J
J
"}
(9,1,1) = {"
J
J
Q
J
J
J
J
J
J
Q
a
a
a
Q
j
j
j
j
j
j
j
j
j
j
j
j
j
j
Q
j
j
j
j
Q
J
J
"}
(10,1,1) = {"
J
J
Q
J
J
J
J
J
J
Q
a
a
a
Q
j
j
Q
k
k
Q
j
j
Q
k
k
Q
j
j
Q
j
j
j
j
Q
Q
Q
"}
(11,1,1) = {"
J
J
Q
J
J
J
J
J
J
Q
a
a
a
a
j
j
k
a
a
E
j
j
D
a
a
k
j
j
Q
j
j
j
j
Q
J
J
"}
(12,1,1) = {"
J
J
Q
J
J
J
J
J
J
Q
a
a
a
a
j
j
k
a
a
E
j
j
D
a
a
k
j
j
Q
j
j
j
j
Q
J
J
"}
(13,1,1) = {"
J
J
Q
J
J
J
J
J
J
Q
Q
Q
Q
Q
j
j
Q
a
U
e
j
j
A
U
a
Q
j
j
Q
j
j
j
j
Q
J
J
"}
(14,1,1) = {"
J
J
Q
J
J
J
J
J
J
J
J
J
J
J
j
j
j
j
j
j
j
j
j
j
j
j
j
j
j
j
j
j
j
Q
J
J
"}
(15,1,1) = {"
J
J
Q
J
J
J
J
J
J
J
J
J
J
J
j
j
j
j
j
j
j
j
j
j
j
j
j
j
j
j
j
j
j
Q
J
J
"}
(16,1,1) = {"
J
J
Q
J
J
J
J
J
J
Q
Q
Q
Q
Q
j
j
Q
a
w
z
j
j
m
w
a
Q
j
j
Q
j
j
j
j
Q
J
J
"}
(17,1,1) = {"
J
J
Q
Q
Q
Q
Q
Q
Q
Q
a
a
a
Q
j
j
k
a
a
E
j
j
D
a
a
k
j
j
Q
j
j
j
j
Q
J
J
"}
(18,1,1) = {"
J
J
J
J
J
J
J
J
J
Q
a
a
a
Q
j
j
k
a
a
E
j
j
D
a
a
k
j
j
Q
j
j
j
j
Q
J
J
"}
(19,1,1) = {"
J
J
J
J
J
J
J
J
J
Q
a
a
a
Q
j
j
Q
k
k
Q
j
j
Q
k
k
Q
j
j
Q
j
j
j
j
Q
J
J
"}
(20,1,1) = {"
J
J
J
J
J
J
J
J
J
Q
a
a
a
a
j
j
j
j
j
j
j
j
j
j
j
j
j
j
Q
j
j
j
j
Q
Q
Q
"}
(21,1,1) = {"
J
J
J
J
J
J
J
J
J
Q
a
a
a
a
j
j
j
j
j
j
j
j
j
j
j
j
j
j
Q
j
j
j
j
Q
J
J
"}
(22,1,1) = {"
J
J
J
J
J
J
J
J
J
Q
Q
i
i
Q
Q
Q
Q
Q
Q
Q
i
i
Q
Q
Q
Q
Q
Q
Q
j
j
j
j
Q
J
J
"}
(23,1,1) = {"
J
J
J
J
J
J
J
J
J
J
Q
i
i
i
i
J
J
J
i
i
i
i
Q
J
J
J
J
J
Q
j
j
j
j
Q
J
J
"}
(24,1,1) = {"
J
J
J
J
J
J
J
J
J
J
Q
i
i
i
i
J
J
J
i
i
i
i
Q
J
J
J
J
J
Q
j
j
j
j
Q
J
J
"}
(25,1,1) = {"
J
J
J
J
J
J
J
J
J
J
Q
i
i
Q
J
J
J
J
J
Q
i
i
Q
J
J
J
J
J
Q
Q
Q
Q
Q
Q
J
J
"}
(26,1,1) = {"
J
J
J
J
J
J
J
J
J
J
Q
Q
Q
Q
J
J
J
J
J
Q
Q
Q
Q
J
J
J
J
J
J
J
J
J
J
J
J
J
"}
