//MAP CONVERTED BY dmm2tgm.py THIS HEADER COMMENT PREVENTS RECONVERSION, DO NOT REMOVE
"a" = (
/turf/open/floor/pod/light,
/area/space)
"b" = (
/obj/machinery/dish_drive/bullet,
/turf/open/floor/pod/dark,
/area/space)
"c" = (
/turf/open/floor/carpet/royalblue,
/area/space)
"d" = (
/obj/structure/window/reinforced/survival_pod/spawner/directional/east,
/turf/open/floor/carpet/black,
/area/space)
"e" = (
/obj/structure/table,
/obj/structure/window/reinforced/survival_pod/spawner/directional/east,
/obj/structure/window/reinforced/survival_pod/spawner/directional/south,
/turf/open/floor/pod/light,
/area/space)
"f" = (
/obj/structure/rack,
/turf/open/floor/pod/dark,
/area/space)
"g" = (
/obj/structure/table,
/turf/open/floor/pod/dark,
/area/space)
"h" = (
/obj/machinery/suit_storage_unit/hc_police,
/obj/structure/window/reinforced/survival_pod/spawner/directional/north,
/turf/open/floor/pod/dark,
/area/space)
"i" = (
/turf/open/floor/plating,
/area/space)
"j" = (
/turf/open/floor/pod/dark,
/area/space)
"k" = (
/obj/structure/grille,
/obj/structure/window/reinforced/shuttle/spaceship,
/turf/open/floor/plating,
/area/space)
"l" = (
/obj/structure/window/reinforced/survival_pod/spawner/directional/south,
/turf/open/floor/carpet/black,
/area/space)
"m" = (
/obj/structure/table,
/obj/structure/window/reinforced/survival_pod/spawner/directional/north,
/obj/structure/window/reinforced/survival_pod/spawner/directional/west,
/turf/open/floor/pod/light,
/area/space)
"n" = (
/turf/open/floor/carpet/black,
/area/space)
"o" = (
/obj/machinery/door/window/survival_pod{
	dir = 8
	},
/turf/open/floor/pod/dark,
/area/space)
"q" = (
/obj/machinery/door/window/survival_pod{
	dir = 4
	},
/turf/open/floor/pod/dark,
/area/space)
"r" = (
/obj/machinery/suit_storage_unit/hc_police,
/obj/structure/window/reinforced/survival_pod/spawner/directional/north,
/obj/structure/window/reinforced/survival_pod/spawner/directional/west,
/turf/open/floor/pod/dark,
/area/space)
"t" = (
/turf/open/floor/wood,
/area/space)
"u" = (
/obj/machinery/door/window/survival_pod/left/directional/west,
/turf/open/floor/pod/light,
/area/space)
"v" = (
/obj/structure/rack/shelf,
/turf/open/floor/pod/dark,
/area/space)
"w" = (
/obj/structure/table,
/obj/structure/window/reinforced/survival_pod/spawner/directional/west,
/turf/open/floor/pod/light,
/area/space)
"x" = (
/obj/machinery/ammo_workbench/unlocked,
/turf/open/floor/pod/dark,
/area/space)
"y" = (
/obj/machinery/door/window/survival_pod,
/turf/open/floor/carpet/black,
/area/space)
"z" = (
/obj/structure/table,
/obj/structure/window/reinforced/survival_pod/spawner/directional/west,
/obj/structure/window/reinforced/survival_pod/spawner/directional/south,
/turf/open/floor/pod/light,
/area/space)
"A" = (
/obj/structure/table,
/obj/structure/window/reinforced/survival_pod/spawner/directional/north,
/obj/structure/window/reinforced/survival_pod/spawner/directional/east,
/turf/open/floor/pod/light,
/area/space)
"B" = (
/obj/structure/rack/gunrack,
/turf/open/floor/pod/dark,
/area/space)
"C" = (
/obj/structure/table/reinforced,
/obj/machinery/recharger{
	pixel_x = -4;
	pixel_y = 5
	},
/obj/machinery/recharger{
	pixel_x = 5;
	pixel_y = 5
	},
/obj/structure/window/reinforced/survival_pod/spawner/directional/west,
/turf/open/floor/pod/dark,
/area/space)
"D" = (
/obj/structure/window/reinforced/survival_pod/spawner/directional/north,
/turf/open/floor/pod/light,
/area/space)
"E" = (
/obj/structure/window/reinforced/survival_pod/spawner/directional/south,
/turf/open/floor/pod/light,
/area/space)
"F" = (
/turf/open/floor/pod,
/area/space)
"I" = (
/obj/structure/table/reinforced,
/obj/machinery/recharger{
	pixel_x = -4;
	pixel_y = 5
	},
/obj/machinery/recharger{
	pixel_x = 5;
	pixel_y = 5
	},
/turf/open/floor/pod/dark,
/area/space)
"J" = (
/turf/template_noop,
/area/space)
"K" = (
/obj/machinery/door/window/survival_pod/left/directional/east,
/turf/open/floor/pod/light,
/area/space)
"L" = (
/turf/open/floor/iron/showroomfloor,
/area/space)
"M" = (
/obj/structure/window/reinforced/survival_pod/spawner/directional/west,
/obj/machinery/suit_storage_unit/hc_police,
/turf/open/floor/pod/dark,
/area/space)
"P" = (
/obj/machinery/vending/security/noaccess,
/turf/open/floor/pod/dark,
/area/space)
"Q" = (
/turf/closed/wall/mineral/titanium/spaceship/nodiagonal,
/area/space)
"R" = (
/turf/open/floor/iron/white,
/area/space)
"S" = (
/obj/machinery/vending/deforest_medvend,
/turf/open/floor/pod/dark,
/area/space)
"T" = (
/turf/open/floor/engine,
/area/space)
"U" = (
/obj/structure/table,
/obj/structure/window/reinforced/survival_pod/spawner/directional/east,
/turf/open/floor/pod/light,
/area/space)
"W" = (
/obj/structure/window/reinforced/survival_pod/spawner/directional/east,
/obj/structure/window/reinforced/survival_pod/spawner/directional/south,
/turf/open/floor/carpet/black,
/area/space)
"Y" = (
/turf/open/floor/iron/kitchen,
/area/space)
"Z" = (
/obj/machinery/suit_storage_unit/hc_police,
/turf/open/floor/pod/dark,
/area/space)

(1,1,1) = {"
J
J
Q
Q
Q
Q
Q
Q
Q
Q
Q
Q
Q
Q
Q
Q
Q
Q
Q
Q
Q
Q
Q
Q
Q
Q
Q
Q
Q
J
J
J
J
J
J
J
"}
(2,1,1) = {"
J
J
Q
c
c
c
Q
R
R
R
Q
t
t
Q
t
t
Q
t
t
Q
t
t
Q
t
t
Q
R
R
Q
J
J
J
J
J
J
J
"}
(3,1,1) = {"
J
J
Q
c
c
c
R
R
R
R
Q
t
t
Q
t
t
Q
t
t
Q
t
t
Q
t
t
Q
R
R
Q
J
J
J
J
J
J
J
"}
(4,1,1) = {"
J
J
Q
c
c
c
Q
Q
Q
Q
Q
Q
t
Q
Q
t
Q
Q
t
Q
Q
t
Q
Q
t
Q
R
R
Q
Q
Q
Q
Q
Q
J
J
"}
(5,1,1) = {"
J
J
Q
c
c
c
c
c
c
Q
F
F
F
F
F
F
F
F
F
F
F
F
F
F
F
Q
R
R
Q
j
j
j
j
Q
J
J
"}
(6,1,1) = {"
J
J
Q
c
c
c
c
c
c
Q
F
F
F
F
F
F
F
F
F
F
F
F
F
F
F
R
R
R
Q
j
j
j
j
Q
J
J
"}
(7,1,1) = {"
J
J
Q
k
k
k
Q
c
c
Q
Q
k
k
Q
Q
k
k
Q
Q
Q
F
F
Q
Q
Q
Q
Q
Q
Q
j
j
j
j
Q
J
J
"}
(8,1,1) = {"
J
J
Q
n
n
n
l
F
F
Q
Y
Y
Y
Q
F
F
F
F
F
F
F
F
F
F
F
F
F
F
Q
j
j
j
j
Q
J
J
"}
(9,1,1) = {"
J
J
Q
n
n
n
l
F
F
k
Y
Y
Y
Q
F
F
F
F
F
F
F
F
F
F
F
F
F
F
Q
j
j
j
j
Q
J
J
"}
(10,1,1) = {"
J
J
Q
n
n
n
y
F
F
k
Y
Y
Y
Q
F
F
Q
k
k
Q
a
a
Q
k
k
Q
F
F
Q
j
j
j
j
Q
Q
Q
"}
(11,1,1) = {"
J
J
Q
n
n
n
y
F
F
k
Y
Y
Y
Y
F
F
k
a
a
E
a
a
D
a
a
k
F
F
Q
j
j
j
j
Q
J
J
"}
(12,1,1) = {"
J
J
Q
n
n
n
l
F
F
Q
Y
Y
Y
Y
F
F
k
a
a
E
a
a
D
a
a
k
F
F
Q
j
j
j
j
Q
J
J
"}
(13,1,1) = {"
J
J
Q
d
d
d
W
F
F
Q
k
k
k
Q
F
F
Q
K
U
e
a
a
A
U
K
Q
F
F
Q
j
j
j
j
Q
J
J
"}
(14,1,1) = {"
J
J
Q
F
F
F
F
F
F
F
F
F
F
F
F
F
a
a
a
a
a
a
a
a
a
a
F
F
j
j
j
j
j
Q
J
J
"}
(15,1,1) = {"
J
J
Q
F
F
F
F
F
F
F
F
F
F
F
F
F
a
a
a
a
a
a
a
a
a
a
F
F
j
j
j
j
j
Q
J
J
"}
(16,1,1) = {"
J
J
Q
o
o
Q
g
g
g
Q
Q
Q
Q
Q
F
F
Q
u
w
z
a
a
m
w
u
Q
F
F
Q
j
j
j
j
Q
J
J
"}
(17,1,1) = {"
J
Q
Q
q
q
Q
Q
Q
Q
Q
L
L
L
Q
F
F
k
a
a
E
a
a
D
a
a
k
F
F
Q
j
j
j
j
Q
J
J
"}
(18,1,1) = {"
J
Q
I
j
j
j
j
j
P
Q
L
L
L
Q
F
F
k
a
a
E
a
a
D
a
a
k
F
F
Q
j
j
j
j
Q
J
J
"}
(19,1,1) = {"
J
Q
b
j
j
j
j
j
S
Q
L
L
L
Q
F
F
Q
k
k
Q
a
a
Q
k
k
Q
F
F
Q
j
j
j
j
Q
J
J
"}
(20,1,1) = {"
J
Q
x
j
j
j
r
o
C
Q
L
L
L
L
F
F
F
F
F
F
F
F
F
F
F
F
F
F
Q
j
j
j
j
Q
Q
Q
"}
(21,1,1) = {"
J
Q
Q
j
j
j
h
j
x
Q
L
L
L
L
F
F
F
F
F
F
F
F
F
F
F
F
F
F
Q
j
j
j
j
Q
J
J
"}
(22,1,1) = {"
J
J
Q
M
M
M
Z
j
Q
Q
Q
i
i
Q
Q
Q
Q
Q
Q
Q
i
i
Q
Q
Q
Q
Q
Q
Q
j
j
j
j
Q
J
J
"}
(23,1,1) = {"
J
J
Q
j
j
j
j
j
Q
J
Q
i
i
i
T
T
T
T
T
i
i
i
Q
J
J
J
J
J
Q
j
j
j
j
Q
J
J
"}
(24,1,1) = {"
J
J
Q
j
j
j
j
j
Q
J
Q
i
i
i
T
T
T
T
T
i
i
i
Q
J
J
J
J
J
Q
j
j
j
j
Q
J
J
"}
(25,1,1) = {"
J
J
Q
B
B
f
v
v
Q
J
Q
i
i
Q
T
T
T
T
T
Q
i
i
Q
J
J
J
J
J
Q
Q
Q
Q
Q
Q
J
J
"}
(26,1,1) = {"
J
J
Q
Q
Q
Q
Q
Q
Q
J
Q
Q
Q
Q
J
T
T
T
J
Q
Q
Q
Q
J
J
J
J
J
J
J
J
J
J
J
J
J
"}
