//MAP CONVERTED BY dmm2tgm.py THIS HEADER COMMENT PREVENTS RECONVERSION, DO NOT REMOVE
"ad" = (
/obj/effect/decal/cleanable/dirt,
/obj/machinery/airalarm/directional/south,
/turf/open/floor/iron/shuttle/cargo,
/area/shuttle/blackmarket_burst)
"aG" = (
/obj/effect/turf_decal/tile/neutral/diagonal_centre,
/obj/effect/turf_decal/box/corners{
	dir = 1
	},
/turf/open/floor/pod/dark,
/area/shuttle/blackmarket_burst)
"bu" = (
/obj/machinery/atmospherics/pipe/smart/manifold4w/supply/hidden/layer4,
/obj/machinery/atmospherics/pipe/smart/manifold4w/scrubbers/hidden/layer2,
/turf/open/floor/iron/shuttle/cargo,
/area/shuttle/blackmarket_burst)
"cL" = (
/obj/machinery/atmospherics/pipe/smart/manifold4w/supply/hidden/layer4,
/obj/machinery/atmospherics/pipe/smart/manifold4w/scrubbers/hidden/layer2,
/obj/effect/decal/cleanable/dirt,
/turf/open/floor/iron/shuttle/cargo,
/area/shuttle/blackmarket_burst)
"dx" = (
/obj/structure/fans/tiny/forcefield{
	dir = 4
	},
/obj/structure/fluff/metalpole/end/left{
	pixel_x = -32;
	pixel_y = 10
	},
/obj/machinery/door/poddoor/ruin{
	dir = 4;
	id = "burstcargo"
	},
/turf/open/floor/engine,
/area/shuttle/blackmarket_burst)
"en" = (
/obj/docking_port/mobile{
	launch_status = 0;
	name = "Burst";
	port_direction = 4;
	preferred_direction = 8;
	shuttle_id = "blackmarket_chevvy";
	dir = 8
	},
/obj/machinery/door/airlock/external/shuttle_ruin{
	dir = 4
	},
/turf/open/floor/catwalk_floor,
/area/shuttle/blackmarket_burst)
"eu" = (
/obj/machinery/door/airlock/external/shuttle_ruin,
/turf/open/floor/catwalk_floor,
/area/shuttle/blackmarket_burst)
"fp" = (
/turf/closed/wall/mineral/titanium/shuttle_ruin,
/area/shuttle/blackmarket_burst)
"jm" = (
/obj/structure/railing,
/obj/effect/turf_decal/tile/neutral/diagonal_centre,
/obj/effect/turf_decal/box/corners{
	dir = 8
	},
/turf/open/floor/pod/dark,
/area/shuttle/blackmarket_burst)
"jD" = (
/obj/machinery/power/shuttle_engine/heater{
	pixel_y = 9
	},
/obj/machinery/atmospherics/components/unary/passive_vent{
	dir = 1;
	name = "killroom vent"
	},
/turf/open/floor/plating,
/area/shuttle/blackmarket_burst)
"ka" = (
/obj/structure/marker_beacon/burgundy,
/turf/closed/wall/mineral/titanium/shuttle_ruin,
/area/shuttle/blackmarket_burst)
"mP" = (
/obj/effect/spawner/random/structure/crate_loot,
/obj/effect/turf_decal/tile/neutral/diagonal_centre,
/obj/structure/railing{
	dir = 6
	},
/obj/effect/turf_decal/box/corners,
/turf/open/floor/pod/dark,
/area/shuttle/blackmarket_burst)
"nB" = (
/obj/machinery/atmospherics/pipe/smart/manifold4w/supply/hidden/layer4,
/obj/machinery/atmospherics/pipe/smart/manifold4w/scrubbers/hidden/layer2,
/obj/machinery/light/cold/directional/north,
/obj/machinery/button/door/directional/north{
	id = "skiffexts";
	name = "External Airlock Bolt Control";
	normaldoorcontrol = 1;
	specialfunctions = 4
	},
/obj/effect/decal/cleanable/dirt,
/turf/open/floor/iron/shuttle/cargo,
/area/shuttle/blackmarket_burst)
"pI" = (
/obj/structure/chair/comfy/shuttle{
	dir = 8
	},
/obj/machinery/atmospherics/components/unary/vent_pump/on/layer4{
	dir = 4
	},
/turf/open/floor/iron/shuttle/ferry,
/area/shuttle/blackmarket_burst)
"pM" = (
/turf/open/floor/iron/shuttle/cargo,
/area/shuttle/blackmarket_burst)
"rE" = (
/obj/machinery/modular_computer/preset/civilian{
	dir = 1
	},
/obj/machinery/light/cold/directional/south,
/obj/machinery/button/door/directional/south{
	id = "burstwindf";
	name = "Window Shutter Control";
	pixel_x = 7
	},
/obj/machinery/button/door/directional/south{
	pixel_x = -7;
	id = "burstcargo";
	name = "Cargo Doors"
	},
/turf/open/floor/iron/shuttle/ferry,
/area/shuttle/blackmarket_burst)
"ss" = (
/obj/effect/decal/cleanable/dirt,
/obj/effect/turf_decal/tile/neutral/diagonal_centre,
/obj/effect/turf_decal/box/corners,
/turf/open/floor/pod/dark,
/area/shuttle/blackmarket_burst)
"tH" = (
/obj/structure/window/reinforced/plasma/spawner/directional/south,
/obj/structure/window/reinforced/survival_pod/spawner/directional/north,
/obj/machinery/atmospherics/pipe/smart/manifold4w/supply/hidden/layer4,
/obj/machinery/atmospherics/pipe/smart/manifold4w/scrubbers/hidden/layer2,
/obj/machinery/portable_atmospherics/canister/oxygen,
/turf/open/floor/catwalk_floor,
/area/shuttle/blackmarket_burst)
"uW" = (
/obj/effect/decal/cleanable/dirt,
/obj/effect/turf_decal/tile/neutral/diagonal_centre,
/obj/effect/turf_decal/box/corners{
	dir = 4
	},
/turf/open/floor/pod/dark,
/area/shuttle/blackmarket_burst)
"vK" = (
/obj/effect/decal/cleanable/dirt,
/obj/structure/closet/emcloset/wall{
	pixel_x = -28
	},
/obj/effect/turf_decal/siding/wideplating/dark{
	dir = 1
	},
/obj/item/storage/toolbox/mechanical,
/turf/open/floor/iron/shuttle/cargo,
/area/shuttle/blackmarket_burst)
"wE" = (
/obj/machinery/atmospherics/pipe/smart/manifold4w/scrubbers/hidden/layer2,
/obj/machinery/atmospherics/components/unary/vent_scrubber/on/layer2{
	dir = 2
	},
/obj/machinery/atmospherics/pipe/smart/manifold4w/supply/hidden/layer4,
/turf/open/floor/iron/shuttle/cargo,
/area/shuttle/blackmarket_burst)
"xQ" = (
/obj/machinery/atmospherics/pipe/smart/manifold4w/scrubbers/hidden/layer2,
/obj/machinery/atmospherics/components/unary/vent_scrubber/on/layer2{
	dir = 1
	},
/obj/machinery/atmospherics/pipe/smart/manifold4w/supply/hidden/layer4,
/turf/open/floor/iron/shuttle/cargo,
/area/shuttle/blackmarket_burst)
"yt" = (
/obj/structure/window/reinforced/shuttle/ruin,
/obj/machinery/door/poddoor/shutters/ruin/preopen{
	dir = 4;
	id = "burstwindf"
	},
/turf/open/floor/plating,
/area/shuttle/blackmarket_burst)
"yM" = (
/obj/machinery/atmospherics/pipe/smart/manifold4w/supply/hidden/layer4,
/obj/machinery/atmospherics/pipe/smart/manifold4w/scrubbers/hidden/layer2,
/obj/effect/decal/cleanable/dirt,
/obj/structure/closet/secure_closet/wall{
	pixel_x = 33
	},
/turf/open/floor/iron/shuttle/ferry,
/area/shuttle/blackmarket_burst)
"zi" = (
/turf/open/floor/catwalk_floor,
/area/shuttle/blackmarket_burst)
"zH" = (
/obj/machinery/power/shuttle_engine/heater{
	pixel_y = 9
	},
/turf/open/floor/plating,
/area/shuttle/blackmarket_burst)
"zQ" = (
/obj/structure/window/reinforced/plasma/spawner/directional/west,
/obj/machinery/airalarm/directional/north,
/obj/machinery/computer/camera_advanced/shuttle_docker/blackmarket_burst{
	dir = 4
	},
/turf/open/floor/iron/shuttle/ferry,
/area/shuttle/blackmarket_burst)
"Dx" = (
/obj/machinery/atmospherics/components/unary/vent_pump/on/layer4{
	dir = 4
	},
/obj/machinery/button/door/directional/south{
	id = "burstcargo";
	name = "Blast Door Control"
	},
/obj/effect/decal/cleanable/dirt,
/obj/effect/turf_decal/siding/wideplating/dark{
	dir = 1
	},
/turf/open/floor/iron/shuttle/cargo,
/area/shuttle/blackmarket_burst)
"DD" = (
/obj/structure/marker_beacon/olive,
/turf/closed/wall/mineral/titanium/shuttle_ruin,
/area/shuttle/blackmarket_burst)
"Ee" = (
/obj/structure/fans/tiny/forcefield{
	dir = 4
	},
/obj/machinery/door/poddoor/ruin{
	dir = 4;
	id = "burstcargo"
	},
/turf/open/floor/engine,
/area/shuttle/blackmarket_burst)
"EO" = (
/obj/machinery/atmospherics/pipe/smart/manifold4w/supply/hidden/layer4,
/obj/machinery/atmospherics/pipe/smart/manifold4w/scrubbers/hidden/layer2,
/turf/open/floor/iron/shuttle/ferry,
/area/shuttle/blackmarket_burst)
"Fr" = (
/obj/machinery/atmospherics/pipe/smart/manifold4w/supply/hidden/layer4,
/obj/effect/turf_decal/siding/wideplating/dark/corner{
	dir = 8
	},
/turf/open/floor/iron/shuttle/cargo,
/area/shuttle/blackmarket_burst)
"Fu" = (
/obj/effect/turf_decal/tile/neutral/diagonal_centre,
/obj/effect/spawner/random/structure/crate_abandoned,
/obj/structure/railing{
	dir = 5
	},
/obj/effect/turf_decal/box/corners{
	dir = 4
	},
/turf/open/floor/pod/dark,
/area/shuttle/blackmarket_burst)
"Gs" = (
/obj/machinery/atmospherics/pipe/smart/manifold4w/scrubbers/hidden/layer2,
/obj/machinery/atmospherics/pipe/smart/manifold4w/supply/hidden/layer4,
/obj/structure/closet/firecloset/wall{
	pixel_x = 31
	},
/turf/open/floor/iron/shuttle/cargo,
/area/shuttle/blackmarket_burst)
"GO" = (
/obj/structure/window/reinforced/shuttle/ruin,
/obj/machinery/door/poddoor/shutters/ruin/preopen,
/turf/open/floor/plating,
/area/shuttle/blackmarket_burst)
"Hj" = (
/obj/effect/decal/cleanable/dirt,
/turf/closed/wall/mineral/titanium/shuttle_ruin/nodiagonal,
/area/shuttle/blackmarket_burst)
"Ii" = (
/obj/structure/window/reinforced/plasma/spawner/directional/south,
/obj/machinery/atmospherics/components/unary/portables_connector/visible/layer4{
	dir = 4
	},
/obj/structure/window/reinforced/survival_pod/spawner/directional/north,
/obj/machinery/portable_atmospherics/canister/air,
/turf/open/floor/iron/shuttle/ferry,
/area/shuttle/blackmarket_burst)
"JW" = (
/obj/effect/turf_decal/siding/wideplating/dark{
	dir = 8
	},
/obj/effect/decal/cleanable/dirt,
/turf/open/floor/iron/shuttle/cargo,
/area/shuttle/blackmarket_burst)
"NC" = (
/obj/machinery/atmospherics/pipe/smart/manifold4w/supply/hidden/layer4,
/turf/open/floor/iron/shuttle/ferry,
/area/shuttle/blackmarket_burst)
"Ov" = (
/turf/template_noop,
/area/template_noop)
"OB" = (
/obj/structure/window/reinforced/plasma/spawner/directional/south,
/obj/structure/window/reinforced/survival_pod/spawner/directional/north,
/obj/machinery/atmospherics/pipe/smart/manifold4w/supply/hidden/layer4,
/turf/open/floor/catwalk_floor,
/area/shuttle/blackmarket_burst)
"OR" = (
/obj/machinery/atmospherics/pipe/smart/manifold4w/supply/hidden/layer4,
/obj/effect/turf_decal/siding/wideplating/dark/corner{
	dir = 1
	},
/obj/effect/decal/cleanable/dirt,
/turf/open/floor/iron/shuttle/cargo,
/area/shuttle/blackmarket_burst)
"PJ" = (
/obj/structure/railing{
	dir = 1
	},
/obj/effect/decal/cleanable/dirt,
/obj/effect/spawner/random/structure/crate_loot,
/obj/effect/turf_decal/tile/neutral/diagonal_centre,
/obj/effect/turf_decal/box/corners{
	dir = 1
	},
/turf/open/floor/pod/dark,
/area/shuttle/blackmarket_burst)
"PY" = (
/obj/machinery/atmospherics/components/unary/vent_pump/on/layer4{
	dir = 4
	},
/obj/effect/turf_decal/siding/wideplating/dark,
/turf/open/floor/iron/shuttle/cargo,
/area/shuttle/blackmarket_burst)
"RN" = (
/obj/structure/window/reinforced/plasma/spawner/directional/west,
/obj/item/radio/intercom/directional/south,
/obj/machinery/computer/shuttle/caravan/blackmarket_burst{
	dir = 4
	},
/turf/open/floor/iron/shuttle/ferry,
/area/shuttle/blackmarket_burst)
"RP" = (
/obj/machinery/atmospherics/pipe/smart/manifold4w/scrubbers/hidden/layer2,
/obj/machinery/atmospherics/pipe/smart/manifold4w/supply/hidden/layer4,
/obj/effect/decal/cleanable/dirt,
/turf/open/floor/iron/shuttle/cargo,
/area/shuttle/blackmarket_burst)
"SY" = (
/obj/effect/turf_decal/tile/neutral/diagonal_centre,
/obj/effect/turf_decal/box/corners{
	dir = 8
	},
/turf/open/floor/pod/dark,
/area/shuttle/blackmarket_burst)
"Tk" = (
/obj/machinery/atmospherics/pipe/smart/manifold4w/scrubbers/hidden/layer2,
/obj/machinery/atmospherics/pipe/smart/manifold4w/supply/hidden/layer4,
/turf/open/floor/iron/shuttle/cargo,
/area/shuttle/blackmarket_burst)
"TD" = (
/obj/effect/turf_decal/siding/wideplating/dark,
/turf/open/floor/iron/shuttle/cargo,
/area/shuttle/blackmarket_burst)
"Vy" = (
/obj/machinery/light/floor,
/obj/effect/turf_decal/siding/wideplating/dark{
	dir = 8
	},
/obj/effect/decal/cleanable/dirt,
/turf/open/floor/iron/shuttle/cargo,
/area/shuttle/blackmarket_burst)
"VX" = (
/obj/structure/window/reinforced/shuttle/ruin,
/obj/machinery/door/poddoor/shutters/ruin/preopen{
	id = "burstwindf"
	},
/turf/open/floor/plating,
/area/shuttle/blackmarket_burst)
"VZ" = (
/obj/structure/chair/comfy/shuttle{
	dir = 8
	},
/obj/machinery/atmospherics/components/unary/vent_scrubber/on/layer2{
	dir = 4
	},
/obj/effect/decal/cleanable/dirt,
/turf/open/floor/iron/shuttle/ferry,
/area/shuttle/blackmarket_burst)
"Wf" = (
/obj/structure/window/reinforced/plasma/spawner/directional/south,
/obj/machinery/door/window/survival_pod/left/directional/north,
/obj/machinery/atmospherics/pipe/smart/manifold4w/supply/hidden/layer4,
/obj/machinery/atmospherics/pipe/smart/manifold4w/scrubbers/hidden/layer2,
/turf/open/floor/catwalk_floor,
/area/shuttle/blackmarket_burst)
"Yg" = (
/obj/machinery/light/cold/directional/north,
/obj/machinery/button/door/directional/north{
	id = "skiffwinds";
	name = "Window Shutter Control"
	},
/obj/effect/decal/cleanable/dirt,
/turf/open/floor/iron/shuttle/cargo,
/area/shuttle/blackmarket_burst)
"YP" = (
/obj/structure/fluff/metalpole/anchor{
	dir = 4;
	pixel_x = -33
	},
/turf/closed/wall/mineral/titanium/shuttle_ruin/nodiagonal,
/area/shuttle/blackmarket_burst)
"YX" = (
/turf/closed/wall/mineral/titanium/shuttle_ruin/nodiagonal,
/area/shuttle/blackmarket_burst)
"ZC" = (
/obj/effect/decal/cleanable/dirt,
/turf/open/floor/iron/shuttle/cargo,
/area/shuttle/blackmarket_burst)
"ZE" = (
/obj/machinery/atmospherics/pipe/smart/manifold4w/supply/hidden/layer4,
/obj/machinery/atmospherics/pipe/smart/manifold4w/scrubbers/hidden/layer2,
/obj/machinery/door/airlock/external/shuttle_ruin,
/turf/open/floor/iron/shuttle/ferry,
/area/shuttle/blackmarket_burst)
"ZW" = (
/obj/machinery/power/shuttle_engine/propulsion/burst/right{
	pixel_y = 10
	},
/turf/template_noop,
/area/shuttle/blackmarket_burst)

(1,1,1) = {"
Ov
fp
YP
dx
Ee
Ee
dx
YP
YX
YX
ka
"}
(2,1,1) = {"
ka
YX
TD
PJ
SY
aG
jm
vK
eu
zi
eu
"}
(3,1,1) = {"
GO
ZC
PY
Fu
ss
uW
mP
Dx
YX
YX
fp
"}
(4,1,1) = {"
YX
Yg
Fr
Vy
JW
JW
Vy
OR
Ii
zH
ZW
"}
(5,1,1) = {"
GO
pM
RP
xQ
Gs
Tk
wE
Tk
OB
zH
ZW
"}
(6,1,1) = {"
DD
YX
zQ
RN
YX
Hj
cL
bu
Wf
zH
ZW
"}
(7,1,1) = {"
Ov
VX
pI
VZ
rE
YX
nB
ZC
tH
jD
ZW
"}
(8,1,1) = {"
Ov
VX
NC
EO
yM
ZE
bu
ad
YX
YX
DD
"}
(9,1,1) = {"
Ov
fp
yt
yt
YX
YX
en
YX
fp
Ov
Ov
"}
