//MAP CONVERTED BY dmm2tgm.py THIS HEADER COMMENT PREVENTS RECONVERSION, DO NOT REMOVE
"a" = (
/turf/template_noop,
/area/template_noop)
"y" = (
/obj/effect/spawner/armory_spawn/shotguns,
/obj/structure/rack/gunrack,
/turf/open/floor/iron/dark,
/area/station/ai_monitored/security/armory)
"F" = (
/obj/structure/rack/gunrack,
/obj/effect/spawner/armory_spawn/mod_lasers_small,
/turf/open/floor/iron/dark,
/area/station/ai_monitored/security/armory)
"I" = (
/obj/effect/turf_decal/tile/red/fourcorners,
/obj/structure/closet/secure_closet/armory_kiboko,
/turf/open/floor/iron/dark,
/area/station/ai_monitored/security/armory)
"O" = (
/obj/structure/rack/gunrack,
/obj/structure/window/reinforced/spawner/directional/east,
/obj/structure/cable,
/obj/effect/spawner/armory_spawn/mod_lasers_big,
/turf/open/floor/iron/dark,
/area/station/ai_monitored/security/armory)
"Z" = (
/obj/structure/window/reinforced/spawner/directional/west,
/obj/effect/spawner/armory_spawn/smg,
/obj/structure/rack/gunrack,
/turf/open/floor/iron/dark,
/area/station/ai_monitored/security/armory)

(1,1,1) = {"
a
a
a
a
a
a
a
a
"}
(2,1,1) = {"
a
a
a
a
a
a
a
a
"}
(3,1,1) = {"
a
a
a
a
a
a
a
a
"}
(4,1,1) = {"
a
a
a
Z
a
a
a
a
"}
(5,1,1) = {"
a
a
a
y
a
a
a
a
"}
(6,1,1) = {"
a
a
a
F
a
a
a
a
"}
(7,1,1) = {"
a
a
a
O
a
a
a
a
"}
(8,1,1) = {"
a
a
a
a
a
a
a
a
"}
(9,1,1) = {"
a
a
a
a
a
a
I
a
"}
