//MAP CONVERTED BY dmm2tgm.py THIS HEADER COMMENT PREVENTS RECONVERSION, DO NOT REMOVE
"a" = (
/turf/template_noop,
/area/template_noop)
"v" = (
/obj/structure/chair/office/light{
	dir = 8
	},
/obj/effect/landmark/start/virologist,
/turf/template_noop,
/area/template_noop)

(1,1,1) = {"
v
a
"}
(2,1,1) = {"
a
a
"}
