//MAP CONVERTED BY dmm2tgm.py THIS HEADER COMMENT PREVENTS RECONVERSION, DO NOT REMOVE
"a" = (
/obj/effect/baseturf_helper/virtual_domain,
/turf/closed/wall/mineral/plastitanium/nodiagonal,
/area/virtual_domain/safehouse)
"b" = (
/obj/structure/closet/crate/secure/weapon,
/obj/item/storage/medkit/combat_surgeon/stocked,
/obj/item/storage/medkit/civil_defense/stocked,
/obj/item/storage/box/survival/syndie,
/obj/item/clothing/head/helmet/sf_peacekeeper,
/obj/item/clothing/suit/armor/sf_peacekeeper,
/obj/item/knife/combat/survival,
/obj/item/ammo_box/magazine/c35sol_pistol,
/obj/item/ammo_box/magazine/c35sol_pistol,
/obj/item/ammo_box/magazine/c35sol_pistol,
/obj/item/ammo_box/magazine/c35sol_pistol,
/obj/item/ammo_box/magazine/c35sol_pistol/stendo,
/obj/item/ammo_box/magazine/c35sol_pistol/stendo,
/obj/item/ammo_box/magazine/c35sol_pistol/stendo,
/obj/item/ammo_box/magazine/c35sol_pistol/stendo,
/obj/item/gun/ballistic/automatic/sol_smg,
/obj/item/gun/ballistic/automatic/pistol/sol,
/obj/effect/turf_decal/stripes/line{
	dir = 4
	},
/obj/effect/turf_decal/stripes/line{
	dir = 8
	},
/obj/effect/turf_decal/sand/volcanic,
/obj/item/clothing/gloves/frontier_colonist,
/obj/item/radio/headset/headset_faction/bowman,
/obj/item/storage/pouch/ammo,
/obj/item/storage/belt/security/webbing/blue,
/obj/item/clothing/glasses/night,
/turf/open/floor/iron,
/area/virtual_domain/safehouse)
"d" = (
/obj/machinery/porta_turret/syndicate/nri_raider/ancient_milsim,
/turf/closed/wall/mineral/plastitanium/nodiagonal,
/area/virtual_domain/safehouse)
"e" = (
/obj/effect/turf_decal/tile/neutral/fourcorners,
/obj/effect/turf_decal/stripes/line,
/obj/effect/decal/cleanable/blood/old,
/obj/effect/decal/cleanable/dirt,
/turf/open/floor/iron,
/area/virtual_domain/safehouse)
"g" = (
/obj/machinery/power/shuttle_engine/heater,
/turf/closed/wall/mineral/plastitanium/nodiagonal,
/area/virtual_domain/safehouse)
"i" = (
/obj/machinery/power/shuttle_engine/propulsion{
	dir = 4
	},
/turf/closed/wall/mineral/plastitanium/nodiagonal,
/area/virtual_domain/safehouse)
"j" = (
/obj/effect/landmark/bitrunning/cache_goal_turf,
/obj/effect/turf_decal/loading_area,
/turf/open/indestructible/bitrunning_transport,
/area/virtual_domain/safehouse)
"m" = (
/obj/effect/turf_decal/tile/neutral/fourcorners,
/obj/effect/turf_decal/stripes/line,
/turf/open/floor/iron,
/area/virtual_domain/safehouse)
"o" = (
/obj/effect/turf_decal/tile/neutral/fourcorners,
/turf/open/floor/iron,
/area/virtual_domain/safehouse)
"p" = (
/obj/effect/turf_decal/tile/neutral/fourcorners,
/obj/effect/turf_decal/stripes/line{
	dir = 4
	},
/obj/structure/chair/comfy/shuttle{
	dir = 1
	},
/obj/machinery/light/small/red/directional/east,
/obj/structure/sign/departments/medbay/alt/directional/east,
/turf/open/floor/iron,
/area/virtual_domain/safehouse)
"q" = (
/obj/modular_map_connector,
/turf/closed/wall/mineral/plastitanium/nodiagonal,
/area/virtual_domain/safehouse)
"r" = (
/turf/closed/wall/mineral/plastitanium/nodiagonal,
/area/virtual_domain/safehouse)
"s" = (
/obj/effect/spawner/structure/window/reinforced/plasma/plastitanium,
/turf/open/floor/plating,
/area/virtual_domain/safehouse)
"v" = (
/obj/effect/turf_decal/stripes/line{
	dir = 1
	},
/obj/machinery/door/airlock/hatch,
/obj/effect/turf_decal/stripes/line,
/obj/effect/turf_decal/sand/volcanic,
/turf/open/floor/iron/white,
/area/virtual_domain/safehouse)
"w" = (
/obj/effect/turf_decal/tile/neutral/half/contrasted{
	dir = 1
	},
/obj/effect/turf_decal/stripes/line,
/obj/effect/landmark/bitrunning/hololadder_spawn,
/turf/open/floor/iron,
/area/virtual_domain/safehouse)
"x" = (
/obj/effect/turf_decal/tile/neutral{
	dir = 4
	},
/obj/effect/turf_decal/stripes/line{
	dir = 6
	},
/obj/machinery/light/small/directional/south,
/obj/effect/decal/cleanable/dirt,
/obj/effect/landmark/bitrunning/hololadder_spawn,
/turf/open/floor/iron,
/area/virtual_domain/safehouse)
"z" = (
/obj/effect/turf_decal/tile/neutral/fourcorners,
/obj/effect/turf_decal/stripes/line{
	dir = 6
	},
/obj/machinery/health_station/directional/east,
/turf/open/floor/iron,
/area/virtual_domain/safehouse)
"D" = (
/obj/effect/turf_decal/tile/neutral/fourcorners,
/obj/effect/decal/cleanable/dirt,
/obj/item/taperecorder/empty,
/turf/open/floor/iron,
/area/virtual_domain/safehouse)
"G" = (
/obj/structure/closet/crate/secure/weapon,
/obj/item/storage/medkit/combat_surgeon/stocked,
/obj/item/storage/medkit/civil_defense/stocked,
/obj/item/storage/box/survival/syndie,
/obj/item/clothing/head/helmet/sf_peacekeeper,
/obj/item/clothing/suit/armor/sf_peacekeeper,
/obj/item/knife/combat/survival,
/obj/item/ammo_box/magazine/c35sol_pistol,
/obj/item/ammo_box/magazine/c35sol_pistol,
/obj/item/ammo_box/magazine/c35sol_pistol,
/obj/item/ammo_box/magazine/c35sol_pistol,
/obj/item/ammo_box/magazine/c35sol_pistol/stendo,
/obj/item/ammo_box/magazine/c35sol_pistol/stendo,
/obj/item/ammo_box/magazine/c35sol_pistol/stendo,
/obj/item/ammo_box/magazine/c35sol_pistol/stendo,
/obj/item/gun/ballistic/automatic/sol_smg,
/obj/item/gun/ballistic/automatic/pistol/sol,
/obj/effect/turf_decal/stripes/end,
/obj/effect/turf_decal/sand/volcanic,
/obj/item/clothing/gloves/frontier_colonist,
/obj/item/radio/headset/headset_faction/bowman,
/obj/item/storage/pouch/ammo,
/obj/item/storage/belt/security/webbing/blue,
/obj/item/clothing/glasses/night,
/turf/open/floor/iron,
/area/virtual_domain/safehouse)
"H" = (
/obj/effect/decal/cleanable/dirt,
/obj/effect/landmark/bitrunning/cache_goal_turf,
/obj/effect/turf_decal/loading_area,
/obj/machinery/light/small/directional/south,
/turf/open/indestructible/bitrunning_transport,
/area/virtual_domain/safehouse)
"I" = (
/obj/effect/turf_decal/tile/neutral,
/obj/effect/turf_decal/stripes/line{
	dir = 5
	},
/obj/effect/decal/cleanable/dirt,
/obj/machinery/computer{
	name = "hovercraft console";
	icon_screen = "shuttle";
	desc = "An armored hovercraft control computer. Doesn't work anymore... who would've thought."
	},
/turf/open/floor/iron,
/area/virtual_domain/safehouse)
"J" = (
/obj/machinery/power/shuttle_engine/propulsion{
	dir = 8
	},
/turf/closed/wall/mineral/plastitanium/nodiagonal,
/area/virtual_domain/safehouse)
"K" = (
/obj/effect/turf_decal/stripes/line{
	dir = 1
	},
/turf/open/floor/iron,
/area/virtual_domain/safehouse)
"L" = (
/obj/effect/turf_decal/tile/neutral/half/contrasted,
/obj/effect/turf_decal/stripes/line{
	dir = 1
	},
/obj/machinery/light/small/red/directional/north,
/obj/effect/decal/cleanable/dirt,
/obj/item/storage/toolbox/emergency,
/turf/open/floor/iron,
/area/virtual_domain/safehouse)
"M" = (
/obj/effect/turf_decal/stripes/line{
	dir = 10
	},
/obj/effect/decal/cleanable/generic,
/obj/effect/landmark/bitrunning/hololadder_spawn,
/turf/open/floor/iron,
/area/virtual_domain/safehouse)
"N" = (
/obj/effect/turf_decal/tile/neutral/half/contrasted,
/obj/effect/turf_decal/stripes/line{
	dir = 1
	},
/obj/effect/decal/cleanable/dirt/dust,
/obj/structure/table/reinforced,
/obj/item/tape/ruins/ancient_milsim/devlog_one,
/turf/open/floor/iron,
/area/virtual_domain/safehouse)
"U" = (
/obj/effect/turf_decal/stripes/end{
	dir = 1
	},
/obj/effect/turf_decal/sand/volcanic,
/obj/structure/closet/crate/secure/weapon,
/obj/item/storage/medkit/combat_surgeon/stocked,
/obj/item/storage/medkit/civil_defense/stocked,
/obj/item/storage/box/survival/syndie,
/obj/item/clothing/head/helmet/sf_peacekeeper,
/obj/item/clothing/suit/armor/sf_peacekeeper,
/obj/item/knife/combat/survival,
/obj/item/ammo_box/magazine/c35sol_pistol,
/obj/item/ammo_box/magazine/c35sol_pistol,
/obj/item/ammo_box/magazine/c35sol_pistol,
/obj/item/ammo_box/magazine/c35sol_pistol,
/obj/item/ammo_box/magazine/c35sol_pistol/stendo,
/obj/item/ammo_box/magazine/c35sol_pistol/stendo,
/obj/item/ammo_box/magazine/c35sol_pistol/stendo,
/obj/item/ammo_box/magazine/c35sol_pistol/stendo,
/obj/item/gun/ballistic/automatic/sol_smg,
/obj/item/gun/ballistic/automatic/pistol/sol,
/obj/item/clothing/gloves/frontier_colonist,
/obj/item/radio/headset/headset_faction/bowman,
/obj/item/storage/pouch/ammo,
/obj/item/storage/belt/security/webbing/blue,
/obj/item/clothing/glasses/night,
/turf/open/floor/iron,
/area/virtual_domain/safehouse)

(1,1,1) = {"
d
J
r
r
J
q
"}
(2,1,1) = {"
r
U
b
G
j
g
"}
(3,1,1) = {"
r
L
o
e
H
g
"}
(4,1,1) = {"
v
K
o
m
M
g
"}
(5,1,1) = {"
s
N
D
m
w
g
"}
(6,1,1) = {"
s
I
p
z
x
g
"}
(7,1,1) = {"
d
i
r
r
i
a
"}
