//MAP CONVERTED BY dmm2tgm.py THIS HEADER COMMENT PREVENTS RECONVERSION, DO NOT REMOVE
"a" = (
/obj/effect/landmark/start/virologist,
/turf/template_noop,
/area/template_noop)
"C" = (
/turf/template_noop,
/area/template_noop)

(1,1,1) = {"
C
a
"}
(2,1,1) = {"
C
C
"}
