//MAP CONVERTED BY dmm2tgm.py THIS HEADER COMMENT PREVENTS RECONVERSION, DO NOT REMOVE
"a" = (
/turf/template_noop,
/area/template_noop)
"e" = (
/obj/item/kinetic_crusher{
	pixel_y = -17;
	pixel_x = -13
	},
/turf/open/misc/asteroid/basalt/lava,
/area/centcom/interlink)
"g" = (
/obj/structure/flora/rock/pile/style_random,
/turf/open/misc/asteroid/basalt/lava,
/area/centcom/interlink)
"h" = (
/obj/structure/marker_beacon/teal,
/turf/open/misc/asteroid/basalt/lava,
/area/centcom/interlink)
"j" = (
/obj/structure/window/reinforced/survival_pod/indestructible/spawner/directional/north,
/turf/open/misc/asteroid/basalt/lava,
/area/centcom/interlink)
"k" = (
/obj/structure/window/reinforced/survival_pod/indestructible/spawner/directional/west,
/obj/structure/window/reinforced/survival_pod/indestructible/spawner/directional/south,
/turf/open/misc/asteroid/basalt/lava,
/area/centcom/interlink)
"n" = (
/obj/structure/window/reinforced/survival_pod/indestructible/spawner/directional/east,
/obj/structure/window/reinforced/survival_pod/indestructible/spawner/directional/south,
/turf/open/misc/asteroid/basalt/lava,
/area/centcom/interlink)
"t" = (
/obj/modular_map_connector,
/obj/structure/sign/plaques/kiddie/diorama/ash{
	pixel_y = 8
	},
/turf/template_noop,
/area/template_noop)
"v" = (
/turf/open/lava/smooth/lava_land_surface,
/area/centcom/interlink)
"x" = (
/obj/structure/window/reinforced/survival_pod/indestructible/spawner/directional/south,
/turf/open/misc/asteroid/basalt/lava,
/area/centcom/interlink)
"y" = (
/obj/structure/marker_beacon/teal,
/obj/structure/window/reinforced/survival_pod/indestructible/spawner/directional/north,
/turf/open/misc/asteroid/basalt/lava,
/area/centcom/interlink)
"z" = (
/obj/structure/window/reinforced/survival_pod/indestructible/spawner/directional/west,
/turf/open/misc/asteroid/basalt/lava,
/area/centcom/interlink)
"H" = (
/obj/structure/window/reinforced/survival_pod/indestructible/spawner/directional/north,
/obj/structure/window/reinforced/survival_pod/indestructible/spawner/directional/west,
/turf/open/misc/asteroid/basalt/lava,
/area/centcom/interlink)
"I" = (
/obj/structure/flora/ash/fireblossom,
/obj/structure/window/reinforced/survival_pod/indestructible/spawner/directional/west,
/turf/open/misc/asteroid/basalt/lava,
/area/centcom/interlink)
"J" = (
/obj/structure/window/reinforced/survival_pod/indestructible/spawner/directional/east,
/turf/open/misc/asteroid/basalt/lava,
/area/centcom/interlink)
"N" = (
/obj/structure/flora/rock/style_random,
/obj/structure/window/reinforced/survival_pod/indestructible/spawner/directional/west,
/turf/open/misc/asteroid/basalt/lava,
/area/centcom/interlink)
"R" = (
/obj/structure/flora/rock/style_random,
/obj/structure/window/reinforced/survival_pod/indestructible/spawner/directional/east,
/obj/structure/window/reinforced/survival_pod/indestructible/spawner/directional/north,
/turf/open/misc/asteroid/basalt/lava,
/area/centcom/interlink)
"U" = (
/obj/structure/flora/ash/fireblossom,
/turf/open/misc/asteroid/basalt/lava,
/area/centcom/interlink)

(1,1,1) = {"
H
I
z
z
N
k
a
"}
(2,1,1) = {"
y
g
g
v
e
x
a
"}
(3,1,1) = {"
j
v
v
v
U
x
t
"}
(4,1,1) = {"
j
v
v
h
g
x
a
"}
(5,1,1) = {"
R
J
J
J
J
n
a
"}
