//MAP CONVERTED BY dmm2tgm.py THIS HEADER COMMENT PREVENTS RECONVERSION, DO NOT REMOVE
"a" = (
/obj/structure/table,
/obj/item/toy/crayon/spraycan/roboticist{
	pixel_x = 1;
	pixel_y = 9
	},
/turf/open/floor/plating,
/area/centcom/interlink)
"b" = (
/obj/machinery/conveyor{
	dir = 5
	},
/obj/structure/window/reinforced/survival_pod/indestructible/spawner/directional/west,
/turf/open/floor/plating,
/area/centcom/interlink)
"d" = (
/obj/machinery/conveyor{
	dir = 5
	},
/obj/structure/window/reinforced/survival_pod/indestructible/spawner/directional/east,
/turf/open/floor/plating,
/area/centcom/interlink)
"f" = (
/obj/machinery/light/floor,
/obj/structure/cable,
/turf/open/floor/catwalk_floor/iron,
/area/centcom/interlink)
"h" = (
/turf/open/floor/plating,
/area/centcom/interlink)
"j" = (
/obj/item/conveyor_switch_construct,
/obj/structure/window/reinforced/survival_pod/indestructible/spawner/directional/south,
/turf/open/floor/catwalk_floor/iron,
/area/centcom/interlink)
"k" = (
/obj/structure/ai_core,
/obj/structure/window/reinforced/survival_pod/indestructible/spawner/directional/east,
/obj/structure/window/reinforced/survival_pod/indestructible/spawner/directional/north,
/turf/open/floor/plating,
/area/centcom/interlink)
"l" = (
/obj/structure/rack,
/obj/structure/window/reinforced/survival_pod/indestructible/spawner/directional/east,
/obj/structure/window/reinforced/survival_pod/indestructible/spawner/directional/south,
/obj/item/book/manual/wiki/robotics_cyborgs,
/turf/open/floor/plating,
/area/centcom/interlink)
"n" = (
/obj/machinery/conveyor{
	dir = 4
	},
/obj/item/bodypart/arm/left/robot,
/turf/open/floor/plating,
/area/centcom/interlink)
"p" = (
/obj/modular_map_connector,
/obj/structure/sign/plaques/kiddie/diorama/borg{
	pixel_y = 8
	},
/turf/template_noop,
/area/template_noop)
"q" = (
/turf/open/floor/catwalk_floor/iron,
/area/centcom/interlink)
"r" = (
/obj/machinery/mechpad,
/obj/structure/window/reinforced/survival_pod/indestructible/spawner/directional/north,
/obj/structure/window/reinforced/survival_pod/indestructible/spawner/directional/west,
/turf/open/floor/plating,
/area/centcom/interlink)
"s" = (
/obj/structure/table,
/obj/structure/cable,
/obj/item/storage/belt/utility/full/inducer,
/obj/structure/window/reinforced/survival_pod/indestructible/spawner/directional/south,
/turf/open/floor/plating,
/area/centcom/interlink)
"t" = (
/obj/structure/window/reinforced/survival_pod/indestructible/spawner/directional/east,
/turf/open/floor/catwalk_floor/iron,
/area/centcom/interlink)
"x" = (
/obj/structure/window/reinforced/survival_pod/indestructible/spawner/directional/west,
/turf/open/floor/plating,
/area/centcom/interlink)
"y" = (
/obj/structure/table,
/obj/structure/window/reinforced/survival_pod/indestructible/spawner/directional/north,
/turf/open/floor/plating,
/area/centcom/interlink)
"z" = (
/obj/structure/rack,
/obj/item/mod/control/pre_equipped/responsory/janitor{
	anchored = 1
	},
/obj/structure/window/reinforced/survival_pod/indestructible/spawner/directional/east,
/turf/open/floor/plating,
/area/centcom/interlink)
"B" = (
/obj/structure/table,
/obj/structure/cable,
/obj/item/stack/sheet/iron/fifty,
/obj/item/stack/sheet/iron/fifty{
	pixel_y = 9;
	pixel_x = 6
	},
/turf/open/floor/plating,
/area/centcom/interlink)
"C" = (
/obj/machinery/mecha_part_fabricator/maint,
/turf/open/floor/plating,
/area/centcom/interlink)
"D" = (
/obj/structure/cable,
/obj/machinery/conveyor{
	dir = 4
	},
/obj/item/bodypart/head/robot,
/turf/open/floor/plating,
/area/centcom/interlink)
"F" = (
/obj/machinery/conveyor{
	dir = 1
	},
/obj/structure/window/reinforced/survival_pod/indestructible/spawner/directional/west,
/obj/item/bodypart/arm/right/robot,
/turf/open/floor/plating,
/area/centcom/interlink)
"I" = (
/obj/machinery/conveyor{
	dir = 1
	},
/obj/structure/window/reinforced/survival_pod/indestructible/spawner/directional/south,
/obj/structure/window/reinforced/survival_pod/indestructible/spawner/directional/west,
/turf/open/floor/plating,
/area/centcom/interlink)
"K" = (
/obj/structure/window/reinforced/survival_pod/indestructible/spawner/directional/east,
/obj/machinery/conveyor/inverted{
	dir = 10
	},
/obj/item/assembly/flash,
/turf/open/floor/plating,
/area/centcom/interlink)
"L" = (
/obj/machinery/conveyor{
	dir = 4
	},
/obj/item/bodypart/chest/robot,
/turf/open/floor/plating,
/area/centcom/interlink)
"S" = (
/obj/machinery/recharge_station,
/obj/structure/cable,
/obj/structure/window/reinforced/survival_pod/indestructible/spawner/directional/north,
/turf/open/floor/plating,
/area/centcom/interlink)
"T" = (
/obj/machinery/light/floor,
/obj/structure/cable,
/turf/open/floor/plating,
/area/centcom/interlink)
"V" = (
/turf/template_noop,
/area/template_noop)
"X" = (
/obj/machinery/conveyor{
	dir = 1
	},
/obj/structure/window/reinforced/survival_pod/indestructible/spawner/directional/west,
/obj/item/assembly/flash,
/turf/open/floor/plating,
/area/centcom/interlink)
"Y" = (
/obj/structure/window/reinforced/survival_pod/indestructible/spawner/directional/south,
/turf/open/floor/plating,
/area/centcom/interlink)

(1,1,1) = {"
r
x
b
X
F
I
V
"}
(2,1,1) = {"
y
a
L
q
q
j
V
"}
(3,1,1) = {"
S
T
D
f
B
s
p
"}
(4,1,1) = {"
y
C
n
q
h
Y
V
"}
(5,1,1) = {"
k
d
K
t
z
l
V
"}
