//MAP CONVERTED BY dmm2tgm.py THIS HEADER COMMENT PREVENTS RECONVERSION, DO NOT REMOVE
"a" = (
/turf/template_noop,
/area/template_noop)
"d" = (
/obj/structure/flora/bush/snow/style_random{
	pixel_x = 5;
	pixel_y = 7
	},
/obj/effect/light_emitter/interlink,
/turf/open/floor/holofloor/snow,
/area/centcom/interlink)
"f" = (
/obj/structure/flora/grass/brown/style_random,
/obj/effect/light_emitter/interlink,
/turf/open/floor/holofloor/snow,
/area/centcom/interlink)
"j" = (
/obj/effect/light_emitter/interlink,
/obj/structure/window/reinforced/survival_pod/indestructible/spawner/directional/south,
/turf/open/floor/holofloor/snow,
/area/centcom/interlink)
"k" = (
/obj/structure/flora/bush/snow/style_random{
	pixel_x = 5;
	pixel_y = 7
	},
/obj/structure/flora/grass/both/style_random,
/obj/effect/light_emitter/interlink,
/turf/open/floor/holofloor/snow,
/area/centcom/interlink)
"l" = (
/obj/modular_map_connector,
/obj/structure/sign/plaques/kiddie/diorama/ice{
	pixel_y = 8
	},
/turf/template_noop,
/area/template_noop)
"m" = (
/mob/living/basic/pet/penguin/emperor,
/obj/effect/light_emitter/interlink,
/turf/open/floor/holofloor/snow,
/area/centcom/interlink)
"o" = (
/obj/effect/light_emitter/interlink,
/obj/structure/window/reinforced/survival_pod/indestructible/spawner/directional/east,
/turf/open/floor/holofloor/snow,
/area/centcom/interlink)
"q" = (
/obj/effect/light_emitter/interlink,
/turf/open/floor/holofloor/snow,
/area/centcom/interlink)
"x" = (
/obj/effect/light_emitter/interlink,
/obj/structure/window/reinforced/survival_pod/indestructible/spawner/directional/east,
/obj/structure/flora/tree/pine/style_random,
/turf/open/floor/holofloor/snow,
/area/centcom/interlink)
"y" = (
/obj/structure/flora/grass/both/style_random,
/obj/effect/light_emitter/interlink,
/obj/structure/window/reinforced/survival_pod/indestructible/spawner/directional/south,
/turf/open/floor/holofloor/snow,
/area/centcom/interlink)
"z" = (
/obj/effect/light_emitter/interlink,
/obj/structure/window/reinforced/survival_pod/indestructible/spawner/directional/north,
/turf/open/floor/holofloor/snow,
/area/centcom/interlink)
"E" = (
/obj/structure/flora/grass/brown/style_random,
/obj/effect/light_emitter/interlink,
/obj/structure/window/reinforced/survival_pod/indestructible/spawner/directional/west,
/turf/open/floor/holofloor/snow,
/area/centcom/interlink)
"H" = (
/obj/effect/light_emitter/interlink,
/obj/structure/window/reinforced/survival_pod/indestructible/spawner/directional/west,
/turf/open/floor/holofloor/snow,
/area/centcom/interlink)
"I" = (
/mob/living/basic/pet/penguin/baby/permanent,
/obj/effect/light_emitter/interlink,
/turf/open/floor/holofloor/snow,
/area/centcom/interlink)
"O" = (
/obj/structure/flora/grass/both/style_random,
/obj/effect/light_emitter/interlink,
/obj/structure/window/reinforced/survival_pod/indestructible/spawner/directional/west,
/turf/open/floor/holofloor/snow,
/area/centcom/interlink)
"P" = (
/obj/structure/flora/grass/both/style_random,
/obj/effect/light_emitter/interlink,
/turf/open/floor/holofloor/snow,
/area/centcom/interlink)
"Q" = (
/obj/effect/light_emitter/interlink,
/obj/structure/window/reinforced/survival_pod/indestructible/spawner/directional/north,
/obj/structure/window/reinforced/survival_pod/indestructible/spawner/directional/east,
/turf/open/floor/holofloor/snow,
/area/centcom/interlink)
"S" = (
/obj/structure/statue/snow/snowman{
	anchored = 1
	},
/obj/effect/light_emitter/interlink,
/turf/open/floor/holofloor/snow,
/area/centcom/interlink)
"T" = (
/obj/effect/light_emitter/interlink,
/obj/structure/window/reinforced/survival_pod/indestructible/spawner/directional/east,
/obj/structure/window/reinforced/survival_pod/indestructible/spawner/directional/south,
/turf/open/floor/holofloor/snow,
/area/centcom/interlink)
"V" = (
/obj/structure/flora/grass/both/style_random,
/obj/effect/light_emitter/interlink,
/obj/structure/window/reinforced/survival_pod/indestructible/spawner/directional/north,
/turf/open/floor/holofloor/snow,
/area/centcom/interlink)
"Y" = (
/obj/effect/light_emitter/interlink,
/obj/structure/window/reinforced/survival_pod/indestructible/spawner/directional/west,
/obj/structure/window/reinforced/survival_pod/indestructible/spawner/directional/south,
/obj/structure/flora/tree/pine/style_random,
/turf/open/floor/holofloor/snow,
/area/centcom/interlink)
"Z" = (
/obj/effect/light_emitter/interlink,
/obj/structure/window/reinforced/survival_pod/indestructible/spawner/directional/west,
/obj/structure/window/reinforced/survival_pod/indestructible/spawner/directional/north,
/obj/structure/flora/tree/pine/style_random,
/turf/open/floor/holofloor/snow,
/area/centcom/interlink)

(1,1,1) = {"
Z
H
O
H
E
Y
a
"}
(2,1,1) = {"
z
m
q
d
f
j
a
"}
(3,1,1) = {"
V
S
I
q
P
y
l
"}
(4,1,1) = {"
z
d
q
m
k
j
a
"}
(5,1,1) = {"
Q
o
x
o
o
T
a
"}
