//MAP CONVERTED BY dmm2tgm.py THIS HEADER COMMENT PREVENTS RECONVERSION, DO NOT REMOVE
"a" = (
/turf/template_noop,
/area/template_noop)
"c" = (
/obj/structure/window/reinforced/survival_pod/indestructible/spawner/directional/east,
/obj/structure/window/reinforced/survival_pod/indestructible/spawner/directional/south,
/turf/open/floor/iron/textured_large,
/area/centcom/interlink)
"g" = (
/obj/item/multitool{
	pixel_x = 12;
	pixel_y = 5
	},
/obj/item/clothing/gloves/chief_engineer{
	pixel_y = -7
	},
/obj/structure/disposalpipe/segment{
	dir = 4
	},
/turf/open/floor/plating,
/area/centcom/interlink)
"h" = (
/obj/structure/window/reinforced/survival_pod/indestructible/spawner/directional/south,
/turf/open/floor/plating,
/area/centcom/interlink)
"i" = (
/obj/structure/disposalpipe/segment{
	dir = 9
	},
/obj/structure/window/reinforced/survival_pod/indestructible/spawner/directional/south,
/obj/structure/window/reinforced/survival_pod/indestructible/spawner/directional/west,
/turf/open/floor/plating,
/area/centcom/interlink)
"j" = (
/obj/structure/disposalpipe/segment{
	dir = 9
	},
/turf/open/floor/plating,
/area/centcom/interlink)
"n" = (
/obj/structure/disposalpipe/segment{
	dir = 4
	},
/obj/structure/window/reinforced/survival_pod/indestructible/spawner/directional/east,
/turf/open/floor/plating,
/area/centcom/interlink)
"q" = (
/obj/structure/disposalpipe/segment{
	dir = 9
	},
/obj/structure/window/reinforced/survival_pod/indestructible/spawner/directional/north,
/turf/open/floor/plating,
/area/centcom/interlink)
"r" = (
/obj/structure/disposalpipe/junction{
	dir = 8
	},
/obj/structure/window/reinforced/survival_pod/indestructible/spawner/directional/east,
/turf/open/floor/plating,
/area/centcom/interlink)
"s" = (
/obj/modular_map_connector,
/obj/structure/sign/plaques/kiddie/diorama/strike{
	pixel_y = 8
	},
/turf/template_noop,
/area/template_noop)
"u" = (
/obj/structure/disposalpipe/segment{
	dir = 10
	},
/obj/structure/window/reinforced/survival_pod/indestructible/spawner/directional/north,
/turf/open/floor/plating,
/area/centcom/interlink)
"v" = (
/obj/structure/disposalpipe/junction{
	dir = 4
	},
/obj/structure/window/reinforced/survival_pod/indestructible/spawner/directional/west,
/turf/open/floor/plating,
/area/centcom/interlink)
"w" = (
/obj/item/stack/tile/carpet/executive/thirty{
	pixel_y = -12;
	pixel_x = -10
	},
/obj/item/stack/tile/iron/fifty{
	pixel_y = 10;
	pixel_x = 10
	},
/obj/structure/disposalpipe/segment{
	dir = 1
	},
/turf/open/floor/plating,
/area/centcom/interlink)
"x" = (
/obj/item/storage/toolbox/emergency/old{
	pixel_y = -5
	},
/obj/structure/disposalpipe/junction{
	dir = 1
	},
/turf/open/floor/plating,
/area/centcom/interlink)
"A" = (
/obj/structure/disposalpipe/segment{
	dir = 4
	},
/obj/item/paper{
	name = "I quit - build your own damn diorama"
	},
/turf/open/floor/plating,
/area/centcom/interlink)
"B" = (
/obj/structure/disposalpipe/rotator,
/turf/open/floor/plating,
/area/centcom/interlink)
"C" = (
/obj/structure/disposalpipe/segment{
	dir = 5
	},
/obj/structure/window/reinforced/survival_pod/indestructible/spawner/directional/west,
/turf/open/floor/plating,
/area/centcom/interlink)
"E" = (
/obj/structure/disposalpipe/segment{
	dir = 6
	},
/obj/structure/window/reinforced/survival_pod/indestructible/spawner/directional/east,
/obj/structure/window/reinforced/survival_pod/indestructible/spawner/directional/north,
/turf/open/floor/plating,
/area/centcom/interlink)
"H" = (
/obj/structure/disposalpipe/segment{
	dir = 4
	},
/obj/structure/window/reinforced/survival_pod/indestructible/spawner/directional/west,
/turf/open/floor/plating,
/area/centcom/interlink)
"K" = (
/obj/structure/disposalpipe/segment{
	dir = 1
	},
/obj/structure/window/reinforced/survival_pod/indestructible/spawner/directional/south,
/turf/open/floor/iron/textured_large,
/area/centcom/interlink)
"L" = (
/obj/structure/disposalpipe/segment{
	dir = 4
	},
/obj/structure/disposalpipe/segment,
/turf/open/floor/plating,
/area/centcom/interlink)
"P" = (
/obj/item/stack/cable_coil/thirty{
	pixel_y = -7;
	pixel_x = -7
	},
/obj/structure/disposalpipe/segment{
	dir = 4
	},
/obj/structure/disposalpipe/segment,
/turf/open/floor/plating,
/area/centcom/interlink)
"T" = (
/obj/structure/disposalpipe/segment{
	dir = 6
	},
/obj/structure/window/reinforced/survival_pod/indestructible/spawner/directional/north,
/turf/open/floor/plating,
/area/centcom/interlink)
"U" = (
/obj/structure/disposalpipe/junction{
	dir = 4
	},
/turf/open/floor/plating,
/area/centcom/interlink)
"V" = (
/turf/open/floor/plating,
/area/centcom/interlink)
"W" = (
/obj/structure/disposalpipe/segment{
	dir = 6
	},
/obj/structure/window/reinforced/survival_pod/indestructible/spawner/directional/north,
/obj/structure/window/reinforced/survival_pod/indestructible/spawner/directional/west,
/turf/open/floor/plating,
/area/centcom/interlink)
"Y" = (
/obj/structure/disposalpipe/segment{
	dir = 10
	},
/obj/structure/window/reinforced/survival_pod/indestructible/spawner/directional/east,
/turf/open/floor/plating,
/area/centcom/interlink)
"Z" = (
/obj/machinery/disposal/bin,
/obj/structure/window/reinforced/survival_pod/indestructible/spawner/directional/east,
/obj/structure/disposalpipe/trunk{
	dir = 8
	},
/turf/open/floor/iron/textured_large,
/area/centcom/interlink)

(1,1,1) = {"
W
C
H
H
v
i
a
"}
(2,1,1) = {"
q
g
A
U
j
h
a
"}
(3,1,1) = {"
T
B
B
j
V
h
s
"}
(4,1,1) = {"
u
P
L
x
w
K
a
"}
(5,1,1) = {"
E
r
n
Y
Z
c
a
"}
