//MAP CONVERTED BY dmm2tgm.py THIS HEADER COMMENT PREVENTS RECONVERSION, DO NOT REMOVE
"a" = (
/obj/structure/window/reinforced/survival_pod/indestructible/spawner/directional/south,
/obj/structure/window/reinforced/survival_pod/indestructible/spawner/directional/north,
/obj/structure/spider/stickyweb,
/obj/machinery/door/window/survival_pod/left/directional/east{
	req_one_access = list("medical")
	},
/turf/open/misc/grass/jungle/station,
/area/centcom/interlink)
"c" = (
/obj/structure/closet/secure_closet/medical2{
	name = "vet closet"
	},
/obj/structure/window/reinforced/survival_pod/indestructible/spawner/directional/east,
/obj/structure/window/reinforced/survival_pod/indestructible/spawner/directional/south,
/obj/effect/turf_decal/siding/blue/end{
	dir = 1
	},
/turf/open/floor/iron/white/textured,
/area/centcom/interlink)
"d" = (
/turf/template_noop,
/area/template_noop)
"f" = (
/obj/structure/table/reinforced/rglass,
/obj/structure/window/reinforced/survival_pod/indestructible/spawner/directional/east,
/obj/structure/window/reinforced/survival_pod/indestructible/spawner/directional/north,
/turf/open/floor/iron/white/smooth_large,
/area/centcom/interlink)
"h" = (
/obj/structure/bed/dogbed,
/obj/structure/window/reinforced/survival_pod/indestructible/spawner/directional/west,
/obj/structure/window/reinforced/survival_pod/indestructible/spawner/directional/north,
/turf/open/misc/grass/jungle/station,
/area/centcom/interlink)
"j" = (
/obj/structure/window/reinforced/tinted/frosted/spawner/directional/west,
/obj/structure/table/reinforced/rglass,
/obj/item/toy/tennis/cyan{
	pixel_y = 1;
	pixel_x = -4
	},
/obj/item/toy/cattoy,
/obj/item/dog_bone{
	pixel_y = 10
	},
/obj/machinery/light/floor,
/obj/item/queen_bee{
	pixel_y = 5;
	pixel_x = 8
	},
/turf/open/floor/iron/white/smooth_large,
/area/centcom/interlink)
"n" = (
/obj/structure/window/reinforced/survival_pod/indestructible/spawner/directional/east,
/turf/open/floor/iron/white/textured,
/area/centcom/interlink)
"o" = (
/obj/structure/bed/dogbed,
/obj/structure/window/reinforced/survival_pod/indestructible/spawner/directional/west,
/obj/structure/window/reinforced/survival_pod/indestructible/spawner/directional/north,
/mob/living/basic/pet/cat/breadcat,
/turf/open/misc/grass/jungle/station,
/area/centcom/interlink)
"r" = (
/turf/open/floor/iron/white/smooth_large,
/area/centcom/interlink)
"t" = (
/obj/effect/turf_decal/siding/blue{
	dir = 8
	},
/turf/open/floor/iron/white/textured_half{
	dir = 1
	},
/area/centcom/interlink)
"u" = (
/obj/structure/table/reinforced/rglass,
/obj/item/surgery_tray/full,
/obj/structure/window/reinforced/tinted/frosted/spawner/directional/west,
/obj/structure/window/reinforced/survival_pod/indestructible/spawner/directional/north,
/turf/open/floor/iron/white/smooth_large,
/area/centcom/interlink)
"v" = (
/obj/structure/window/reinforced/tinted/frosted/spawner/directional/west,
/obj/machinery/light/floor,
/turf/open/floor/iron/white/smooth_large,
/area/centcom/interlink)
"x" = (
/mob/living/basic/pet/cat{
	name = "Mr. Spoon"
	},
/obj/machinery/door/window/survival_pod/left/directional/east{
	req_one_access = list("medical")
	},
/obj/structure/window/reinforced/survival_pod/indestructible/spawner/directional/north,
/turf/open/misc/grass/jungle/station,
/area/centcom/interlink)
"y" = (
/mob/living/basic/pet/cat/fennec{
	name = "Ear Bud"
	},
/obj/structure/window/reinforced/survival_pod/indestructible/spawner/directional/north,
/obj/machinery/door/window/survival_pod/left/directional/east{
	req_one_access = list("medical")
	},
/turf/open/misc/grass/jungle/station,
/area/centcom/interlink)
"z" = (
/obj/structure/window/reinforced/survival_pod/indestructible/spawner/directional/south,
/obj/effect/turf_decal/siding/blue{
	dir = 8
	},
/turf/open/floor/iron/white/textured_half{
	dir = 1
	},
/area/centcom/interlink)
"A" = (
/obj/structure/bed/dogbed,
/obj/structure/window/reinforced/survival_pod/indestructible/spawner/directional/south,
/obj/structure/window/reinforced/survival_pod/indestructible/spawner/directional/west,
/obj/structure/window/reinforced/survival_pod/indestructible/spawner/directional/north,
/obj/structure/spider/stickyweb,
/mob/living/basic/spider/giant/ogre{
	ai_controller = /datum/ai_controller/basic_controller/giant_spider/pest;
	name = "Pantry";
	faction = list("neutral");
	real_name = "Pantry"
	},
/turf/open/misc/grass/jungle/station,
/area/centcom/interlink)
"B" = (
/obj/machinery/light/floor,
/obj/effect/turf_decal/siding/blue{
	dir = 8
	},
/turf/open/floor/iron/white/textured_half{
	dir = 1
	},
/area/centcom/interlink)
"D" = (
/obj/structure/window/reinforced/tinted/frosted/spawner/directional/west,
/obj/structure/table/reinforced/rglass,
/obj/item/pet_carrier{
	pixel_y = 1;
	pixel_x = -7
	},
/obj/item/pet_carrier/biopod{
	pixel_y = 1;
	pixel_x = 10
	},
/obj/structure/window/reinforced/survival_pod/indestructible/spawner/directional/south,
/turf/open/floor/iron/white/smooth_large,
/area/centcom/interlink)
"F" = (
/obj/structure/window/reinforced/survival_pod/indestructible/spawner/directional/north,
/obj/machinery/door/window/survival_pod/left/directional/east{
	req_one_access = list("medical")
	},
/turf/open/misc/grass/jungle/station,
/area/centcom/interlink)
"I" = (
/obj/structure/bed/dogbed,
/obj/structure/window/reinforced/survival_pod/indestructible/spawner/directional/north,
/obj/structure/window/reinforced/survival_pod/indestructible/spawner/directional/west,
/turf/open/misc/grass/jungle/station,
/area/centcom/interlink)
"J" = (
/obj/structure/window/reinforced/survival_pod/indestructible/spawner/directional/north,
/obj/effect/turf_decal/siding/blue{
	dir = 8
	},
/turf/open/floor/iron/white/textured_half{
	dir = 1
	},
/area/centcom/interlink)
"K" = (
/obj/structure/table/optable,
/obj/structure/window/reinforced/survival_pod/indestructible/spawner/directional/east,
/turf/open/floor/iron/white/textured,
/area/centcom/interlink)
"O" = (
/mob/living/basic/pet/cat/tabby{
	name = "Cheddar Cheese"
	},
/obj/structure/bed/dogbed,
/obj/structure/window/reinforced/survival_pod/indestructible/spawner/directional/west,
/obj/structure/window/reinforced/survival_pod/indestructible/spawner/directional/north,
/turf/open/misc/grass/jungle/station,
/area/centcom/interlink)
"P" = (
/obj/modular_map_connector,
/obj/structure/sign/plaques/kiddie/diorama/vet{
	pixel_y = 8
	},
/turf/template_noop,
/area/template_noop)
"Y" = (
/obj/structure/bed/dogbed,
/obj/structure/window/reinforced/survival_pod/indestructible/spawner/directional/west,
/obj/structure/window/reinforced/survival_pod/indestructible/spawner/directional/north,
/mob/living/basic/pet/dog/corgi/puppy/slime{
	name = "Pink"
	},
/turf/open/misc/grass/jungle/station,
/area/centcom/interlink)

(1,1,1) = {"
I
o
O
Y
h
A
d
"}
(2,1,1) = {"
x
F
F
F
y
a
d
"}
(3,1,1) = {"
J
B
t
t
B
z
P
"}
(4,1,1) = {"
u
v
r
r
j
D
d
"}
(5,1,1) = {"
f
K
n
n
n
c
d
"}
