//MAP CONVERTED BY dmm2tgm.py THIS HEADER COMMENT PREVENTS RECONVERSION, DO NOT REMOVE
"a" = (
/obj/structure/window/reinforced/survival_pod/indestructible,
/obj/structure/window/reinforced/survival_pod/indestructible{
	dir = 1
	},
/obj/machinery/door/window/survival_pod/left/directional/east,
/turf/open/misc/grass/jungle/station,
/area/centcom/interlink)
"c" = (
/obj/structure/window/reinforced/survival_pod/indestructible{
	dir = 4
	},
/obj/structure/window/reinforced/survival_pod/indestructible,
/obj/structure/closet/secure_closet/medical2{
	name = "vet closet"
	},
/turf/open/floor/iron/white/textured,
/area/centcom/interlink)
"d" = (
/turf/template_noop,
/area/template_noop)
"f" = (
/obj/structure/window/reinforced/survival_pod/indestructible{
	dir = 4
	},
/obj/structure/table/reinforced/rglass,
/obj/structure/window/reinforced/survival_pod/indestructible{
	dir = 1
	},
/turf/open/floor/iron/white/smooth_large,
/area/centcom/interlink)
"h" = (
/mob/living/basic/pet/cat/kitten,
/obj/structure/window/reinforced/survival_pod/indestructible{
	dir = 1
	},
/obj/machinery/door/window/survival_pod/left/directional/east,
/turf/open/misc/grass/jungle/station,
/area/centcom/interlink)
"j" = (
/obj/structure/window/reinforced/tinted/frosted/spawner/directional/west,
/obj/structure/table/reinforced/rglass,
/obj/item/toy/tennis/cyan{
	pixel_y = 1;
	pixel_x = -4
	},
/obj/item/toy/cattoy,
/obj/item/dog_bone{
	pixel_y = 10
	},
/obj/machinery/light/floor,
/turf/open/floor/iron/white/smooth_large,
/area/centcom/interlink)
"n" = (
/obj/structure/window/reinforced/survival_pod/indestructible{
	dir = 4
	},
/turf/open/floor/iron/white/textured,
/area/centcom/interlink)
"o" = (
/obj/structure/window/reinforced/survival_pod/indestructible{
	dir = 8
	},
/obj/structure/bed/dogbed,
/obj/structure/window/reinforced/survival_pod/indestructible{
	dir = 1
	},
/mob/living/basic/pet/dog/corgi/narsie,
/turf/open/misc/grass/jungle/station,
/area/centcom/interlink)
"r" = (
/turf/open/floor/iron/white/smooth_large,
/area/centcom/interlink)
"t" = (
/turf/open/floor/iron/white/textured_half{
	dir = 1
	},
/area/centcom/interlink)
"u" = (
/obj/structure/table/reinforced/rglass,
/obj/item/surgery_tray/full,
/obj/structure/window/reinforced/survival_pod/indestructible{
	dir = 1
	},
/obj/structure/window/reinforced/tinted/frosted/spawner/directional/west,
/turf/open/floor/iron/white/smooth_large,
/area/centcom/interlink)
"v" = (
/obj/structure/window/reinforced/tinted/frosted/spawner/directional/west,
/obj/machinery/light/floor,
/turf/open/floor/iron/white/smooth_large,
/area/centcom/interlink)
"x" = (
/obj/structure/window/reinforced/survival_pod/indestructible{
	dir = 1
	},
/mob/living/basic/pet/cat,
/obj/machinery/door/window/survival_pod/left/directional/east,
/turf/open/misc/grass/jungle/station,
/area/centcom/interlink)
"y" = (
/mob/living/basic/pet/cat/fennec,
/obj/structure/window/reinforced/survival_pod/indestructible{
	dir = 1
	},
/obj/machinery/door/window/survival_pod/left/directional/east,
/turf/open/misc/grass/jungle/station,
/area/centcom/interlink)
"z" = (
/obj/structure/window/reinforced/survival_pod/indestructible,
/turf/open/floor/iron/white/textured_half{
	dir = 1
	},
/area/centcom/interlink)
"A" = (
/obj/structure/window/reinforced/survival_pod/indestructible,
/obj/structure/window/reinforced/survival_pod/indestructible{
	dir = 8
	},
/obj/structure/bed/dogbed,
/obj/structure/window/reinforced/survival_pod/indestructible{
	dir = 1
	},
/mob/living/basic/pet/cat/breadcat,
/turf/open/misc/grass/jungle/station,
/area/centcom/interlink)
"B" = (
/obj/machinery/light/floor,
/turf/open/floor/iron/white/textured_half{
	dir = 1
	},
/area/centcom/interlink)
"D" = (
/obj/structure/window/reinforced/survival_pod/indestructible,
/obj/structure/window/reinforced/tinted/frosted/spawner/directional/west,
/obj/structure/table/reinforced/rglass,
/obj/item/pet_carrier{
	pixel_y = 1;
	pixel_x = -7
	},
/obj/item/pet_carrier/biopod{
	pixel_y = 1;
	pixel_x = 10
	},
/turf/open/floor/iron/white/smooth_large,
/area/centcom/interlink)
"F" = (
/obj/structure/window/reinforced/survival_pod/indestructible{
	dir = 1
	},
/obj/machinery/door/window/survival_pod/left/directional/east,
/turf/open/misc/grass/jungle/station,
/area/centcom/interlink)
"I" = (
/obj/structure/window/reinforced/survival_pod/indestructible{
	dir = 1
	},
/obj/structure/window/reinforced/survival_pod/indestructible{
	dir = 8
	},
/obj/structure/bed/dogbed,
/turf/open/misc/grass/jungle/station,
/area/centcom/interlink)
"J" = (
/obj/structure/window/reinforced/survival_pod/indestructible{
	dir = 1
	},
/turf/open/floor/iron/white/textured_half{
	dir = 1
	},
/area/centcom/interlink)
"K" = (
/obj/structure/window/reinforced/survival_pod/indestructible{
	dir = 4
	},
/obj/structure/table/optable,
/turf/open/floor/iron/white/textured,
/area/centcom/interlink)
"O" = (
/obj/structure/window/reinforced/survival_pod/indestructible{
	dir = 8
	},
/mob/living/basic/pet/cat/tabby,
/obj/structure/bed/dogbed,
/obj/structure/window/reinforced/survival_pod/indestructible{
	dir = 1
	},
/turf/open/misc/grass/jungle/station,
/area/centcom/interlink)
"P" = (
/obj/modular_map_connector,
/obj/structure/sign/plaques/kiddie/diorama/vet,
/turf/template_noop,
/area/template_noop)
"Y" = (
/obj/structure/window/reinforced/survival_pod/indestructible{
	dir = 8
	},
/obj/structure/bed/dogbed,
/obj/structure/window/reinforced/survival_pod/indestructible{
	dir = 1
	},
/turf/open/misc/grass/jungle/station,
/area/centcom/interlink)

(1,1,1) = {"
I
o
O
Y
Y
A
d
"}
(2,1,1) = {"
x
F
F
h
y
a
d
"}
(3,1,1) = {"
J
B
t
t
B
z
P
"}
(4,1,1) = {"
u
v
r
r
j
D
d
"}
(5,1,1) = {"
f
K
n
n
n
c
d
"}
