//MAP CONVERTED BY dmm2tgm.py THIS HEADER COMMENT PREVENTS RECONVERSION, DO NOT REMOVE
"ay" = (
/obj/structure/railing/corner/end{
	dir = 4
	},
/obj/machinery/door/airlock/uranium/safe,
/obj/structure/railing/corner/end/flip{
	dir = 4
	},
/turf/open/floor/engine/cult,
/area/deathmatch)
"aT" = (
/obj/item/cardboard_cutout/adaptive{
	pixel_y = 14;
	pixel_x = 8
	},
/obj/effect/decal/cleanable/cobweb,
/obj/effect/decal/cleanable/dirt/dust,
/turf/open/floor/engine/cult,
/area/deathmatch)
"bb" = (
/obj/structure/chair/wood/wings{
	dir = 8
	},
/obj/effect/light_emitter{
	set_cap = 2;
	light_color = "#DEEFFF";
	set_luminosity = 4
	},
/turf/open/floor/engine/cult,
/area/deathmatch)
"bg" = (
/obj/effect/spawner/random/entertainment/arcade,
/turf/open/floor/engine/cult,
/area/deathmatch)
"bv" = (
/obj/machinery/power/shuttle_engine/propulsion,
/turf/open/floor/plating/airless,
/area/deathmatch)
"co" = (
/obj/structure/table/reinforced,
/obj/item/paper_bin/carbon{
	pixel_y = 12;
	pixel_x = 7
	},
/obj/item/stamp/granted{
	pixel_y = 2;
	pixel_x = 8
	},
/obj/item/stamp/denied{
	pixel_x = 10;
	pixel_y = -3
	},
/turf/open/floor/engine/cult,
/area/deathmatch)
"cU" = (
/obj/structure/chair/wood/wings{
	dir = 1
	},
/turf/open/floor/engine/cult,
/area/deathmatch)
"dj" = (
/obj/machinery/door/airlock/uranium/safe,
/obj/effect/mapping_helpers/airlock_note_placer{
	note_info = "Don't forget the book above your desk. Also, your other clothes are in your dresser. -Mom"
	},
/turf/open/floor/engine/cult,
/area/deathmatch)
"ds" = (
/turf/open/floor/carpet/purple,
/area/deathmatch)
"eo" = (
/obj/structure/flora/bush/grassy/style_random,
/mob/living/simple_animal/pet/gondola{
	name = "Jommy";
	faction = list("gondola", "Wizard")
	},
/turf/open/floor/grass,
/area/deathmatch)
"ez" = (
/obj/structure/closet/crate,
/obj/item/banhammer,
/obj/item/toy/eldritch_book,
/turf/open/floor/engine/cult,
/area/deathmatch)
"fH" = (
/obj/effect/turf_decal/tile/bar/opposingcorners,
/obj/machinery/griddle,
/turf/open/floor/iron,
/area/deathmatch)
"fI" = (
/turf/open/lava,
/area/deathmatch)
"gn" = (
/obj/structure/window/green_glass_pane,
/obj/effect/light_emitter{
	set_cap = 2;
	light_color = "#DEEFFF";
	set_luminosity = 4
	},
/turf/open/floor/engine/cult,
/area/deathmatch)
"gr" = (
/obj/effect/turf_decal/tile/bar/opposingcorners,
/obj/structure/chair/wood,
/turf/open/floor/iron,
/area/deathmatch)
"gR" = (
/obj/effect/turf_decal/tile/bar/opposingcorners,
/obj/structure/table/reinforced,
/obj/item/food/burger/spell{
	pixel_y = 11;
	pixel_x = -3
	},
/obj/item/stack/medical/ointment{
	pixel_y = -2;
	pixel_x = 9
	},
/turf/open/floor/iron,
/area/deathmatch)
"hg" = (
/obj/structure/railing/corner/end/flip{
	dir = 8
	},
/obj/machinery/door/airlock/uranium/safe,
/obj/structure/railing/corner/end{
	dir = 8
	},
/turf/open/floor/engine/cult,
/area/deathmatch)
"hk" = (
/obj/item/kirbyplants/organic/plant10{
	pixel_y = 21;
	pixel_x = -7
	},
/turf/open/floor/engine/cult,
/area/deathmatch)
"hK" = (
/obj/effect/decal/cleanable/dirt/dust,
/obj/effect/light_emitter{
	set_cap = 2;
	light_color = "#DEEFFF";
	set_luminosity = 4
	},
/turf/open/floor/engine/cult,
/area/deathmatch)
"ig" = (
/obj/structure/table/wood,
/obj/item/flashlight/lamp/green{
	pixel_x = 6;
	pixel_y = 14
	},
/obj/item/book/manual/wiki/ordnance{
	pixel_y = 4;
	pixel_x = 3;
	page_link = "Wizard";
	name = "Wizarding Tome - How to Wizard";
	desc = "Everything you need to know to be a wizard."
	},
/obj/item/stack/medical/bruise_pack{
	pixel_x = -12
	},
/obj/item/reagent_containers/cup/glass/mug/coco{
	pixel_x = -11;
	pixel_y = 1
	},
/turf/open/floor/engine/cult,
/area/deathmatch)
"iz" = (
/obj/structure/chair/comfy/brown{
	dir = 1
	},
/turf/open/floor/engine/cult,
/area/deathmatch)
"iL" = (
/obj/effect/light_emitter{
	set_cap = 2;
	light_color = "#DEEFFF";
	set_luminosity = 4
	},
/turf/open/floor/carpet/red,
/area/deathmatch)
"iQ" = (
/obj/structure/table,
/obj/structure/bedsheetbin{
	pixel_y = 4;
	pixel_x = 3
	},
/turf/open/floor/plastic,
/area/deathmatch)
"iZ" = (
/obj/effect/turf_decal/tile/bar/opposingcorners,
/obj/structure/sink/directional/west,
/turf/open/floor/iron,
/area/deathmatch)
"jb" = (
/obj/machinery/door/airlock/uranium/safe,
/obj/structure/railing/corner/end/flip,
/obj/structure/railing/corner/end,
/turf/open/floor/engine/cult,
/area/deathmatch)
"jg" = (
/obj/effect/turf_decal/tile/bar/opposingcorners,
/obj/effect/landmark/deathmatch_player_spawn,
/turf/open/floor/iron,
/area/deathmatch)
"jm" = (
/obj/effect/decal/cleanable/dirt/dust,
/obj/structure/mystery_box/wands,
/turf/open/floor/engine/cult,
/area/deathmatch)
"js" = (
/obj/effect/turf_decal/tile/bar/opposingcorners,
/turf/open/floor/iron,
/area/deathmatch)
"jM" = (
/obj/structure/table/reinforced,
/obj/effect/spawner/random/bureaucracy/paper{
	pixel_y = 4;
	pixel_x = 4
	},
/obj/item/pen{
	pixel_x = -5
	},
/obj/effect/decal/cleanable/dirt/dust,
/turf/open/floor/engine/cult,
/area/deathmatch)
"jV" = (
/obj/effect/turf_decal/tile/bar/opposingcorners,
/obj/machinery/door/airlock/uranium/safe,
/turf/open/floor/iron,
/area/deathmatch)
"kl" = (
/obj/structure/flora/bush/grassy/style_random,
/obj/machinery/light/floor,
/obj/effect/light_emitter{
	set_cap = 2;
	light_color = "#DEEFFF";
	set_luminosity = 4
	},
/turf/open/floor/grass,
/area/deathmatch)
"li" = (
/obj/structure/table,
/obj/item/extinguisher{
	pixel_x = 7;
	pixel_y = -6
	},
/obj/item/clothing/suit/wizrobe/red{
	pixel_y = 3;
	pixel_x = -6
	},
/turf/open/floor/engine/cult,
/area/deathmatch)
"lM" = (
/obj/structure/bed{
	dir = 1
	},
/obj/item/bedsheet/wiz{
	dir = 1
	},
/obj/effect/light_emitter{
	set_cap = 2;
	light_color = "#DEEFFF";
	set_luminosity = 4
	},
/turf/open/floor/engine/cult,
/area/deathmatch)
"lO" = (
/obj/structure/closet/crate,
/obj/effect/spawner/random/exotic/languagebook,
/obj/effect/decal/cleanable/dirt/dust,
/obj/item/storage/crayons,
/turf/open/floor/engine/cult,
/area/deathmatch)
"mb" = (
/obj/machinery/computer,
/turf/open/floor/engine/cult,
/area/deathmatch)
"mu" = (
/obj/effect/turf_decal/stripes,
/obj/structure/railing{
	dir = 4
	},
/turf/open/floor/iron,
/area/deathmatch)
"nk" = (
/obj/effect/light_emitter{
	set_cap = 2;
	light_color = "#DEEFFF";
	set_luminosity = 4
	},
/turf/open/floor/carpet/purple,
/area/deathmatch)
"nx" = (
/obj/effect/landmark/deathmatch_player_spawn,
/turf/open/floor/carpet/red,
/area/deathmatch)
"nQ" = (
/obj/machinery/door/airlock/uranium/safe,
/turf/open/floor/plastic,
/area/deathmatch)
"nV" = (
/obj/structure/table/wood,
/obj/item/clothing/mask/cigarette/cigar{
	pixel_y = -9;
	pixel_x = -5
	},
/obj/item/camera/spooky{
	pixel_y = 7;
	pixel_x = 2
	},
/turf/open/floor/engine/cult,
/area/deathmatch)
"ok" = (
/obj/structure/railing{
	dir = 4
	},
/obj/structure/railing{
	dir = 8
	},
/obj/structure/mystery_box/tdome,
/turf/open/floor/engine/cult,
/area/deathmatch)
"on" = (
/obj/structure/table/wood,
/turf/open/floor/carpet/red,
/area/deathmatch)
"oP" = (
/obj/structure/destructible/cult/item_dispenser/archives/library,
/turf/open/floor/engine/cult,
/area/deathmatch)
"pe" = (
/obj/item/kirbyplants/organic/plant10{
	pixel_y = 21;
	pixel_x = -7
	},
/turf/open/floor/carpet/red,
/area/deathmatch)
"ph" = (
/turf/open/floor/engine/cult,
/area/deathmatch)
"pv" = (
/obj/effect/light_emitter{
	set_cap = 2;
	light_color = "#DEEFFF";
	set_luminosity = 4
	},
/turf/open/floor/iron,
/area/deathmatch)
"pL" = (
/obj/effect/turf_decal/stripes{
	dir = 1
	},
/obj/structure/mystery_box/wands,
/turf/open/floor/engine/cult,
/area/deathmatch)
"pV" = (
/obj/structure/flora/bush/flowers_br/style_random,
/turf/open/floor/grass,
/area/deathmatch)
"qY" = (
/obj/structure/closet/crate/bin,
/obj/item/trash/boritos/purple,
/turf/open/floor/engine/cult,
/area/deathmatch)
"rj" = (
/obj/machinery/door/window/right/directional/east,
/turf/open/floor/engine/cult,
/area/deathmatch)
"rD" = (
/obj/structure/railing{
	dir = 4
	},
/obj/structure/railing{
	dir = 8
	},
/turf/open/floor/engine/cult,
/area/deathmatch)
"sf" = (
/obj/structure/mirror/directional/east,
/turf/open/floor/engine/cult,
/area/deathmatch)
"tL" = (
/obj/structure/flora/bush/fullgrass/style_random,
/mob/living/simple_animal/hostile/ooze/gelatinous{
	name = "Jimmy";
	faction = list("slime", "Wizard")
	},
/turf/open/floor/grass,
/area/deathmatch)
"ue" = (
/obj/effect/turf_decal/tile/bar/opposingcorners,
/obj/item/food/burger/yellow{
	pixel_x = -11;
	pixel_y = 8
	},
/obj/item/food/burger/red{
	pixel_y = 13;
	pixel_x = 6
	},
/obj/item/food/burger/purple{
	pixel_y = 3
	},
/obj/structure/table/reinforced,
/turf/open/floor/iron,
/area/deathmatch)
"ui" = (
/obj/effect/turf_decal/stripes,
/turf/open/floor/iron,
/area/deathmatch)
"uz" = (
/turf/open/floor/iron,
/area/deathmatch)
"uM" = (
/obj/structure/table/wood,
/obj/item/toy/figure/wizard{
	pixel_y = 16;
	pixel_x = 4
	},
/obj/item/toy/cards/deck/tarot{
	pixel_x = 6;
	pixel_y = 4
	},
/obj/item/toy/cards/deck/wizoff{
	pixel_x = -6;
	pixel_y = 4
	},
/turf/open/floor/engine/cult,
/area/deathmatch)
"uR" = (
/obj/item/clothing/shoes/sandal/magic{
	pixel_y = 16
	},
/obj/effect/light_emitter{
	set_cap = 2;
	light_color = "#DEEFFF";
	set_luminosity = 4
	},
/turf/open/floor/plastic,
/area/deathmatch)
"vh" = (
/obj/structure/mystery_box/wands,
/turf/open/floor/engine/cult,
/area/deathmatch)
"vv" = (
/obj/vehicle/ridden/scooter/skateboard{
	dir = 4
	},
/obj/effect/decal/cleanable/dirt/dust,
/turf/open/floor/engine/cult,
/area/deathmatch)
"vR" = (
/obj/structure/bookcase/random,
/turf/open/floor/engine/cult,
/area/deathmatch)
"wd" = (
/obj/effect/turf_decal/tile/bar/opposingcorners,
/obj/structure/mystery_box/wands,
/turf/open/floor/iron,
/area/deathmatch)
"wl" = (
/obj/item/kirbyplants/organic/plant10{
	pixel_y = 1;
	pixel_x = -6
	},
/turf/open/floor/carpet/purple,
/area/deathmatch)
"wt" = (
/obj/item/gun/magic/wand/death,
/obj/structure/window/reinforced/plasma{
	dir = 8
	},
/obj/structure/window/reinforced/plasma{
	dir = 4
	},
/obj/structure/window/reinforced/plasma{
	dir = 1
	},
/turf/open/floor/grass,
/area/deathmatch)
"wL" = (
/obj/effect/turf_decal/tile/bar/opposingcorners,
/obj/machinery/gibber/autogibber,
/turf/open/floor/iron,
/area/deathmatch)
"xk" = (
/obj/structure/sink/directional/south,
/obj/structure/mirror/directional/north{
	pixel_y = 36
	},
/turf/open/floor/plastic,
/area/deathmatch)
"xs" = (
/obj/structure/flora/bush/grassy/style_random,
/turf/open/floor/grass,
/area/deathmatch)
"yA" = (
/obj/structure/chair/wood/wings,
/turf/open/floor/engine/cult,
/area/deathmatch)
"zz" = (
/obj/structure/table/wood,
/obj/item/reagent_containers/cup/glass/bottle/beer{
	pixel_x = -8;
	pixel_y = 17
	},
/turf/open/floor/engine/cult,
/area/deathmatch)
"zN" = (
/obj/structure/mystery_box/wands,
/obj/structure/sign/poster/contraband/the_big_gas_giant_truth/directional/north,
/turf/open/floor/engine/cult,
/area/deathmatch)
"zO" = (
/obj/structure/closet,
/turf/open/floor/engine/cult,
/area/deathmatch)
"Au" = (
/obj/structure/railing{
	dir = 4
	},
/turf/open/floor/engine/cult,
/area/deathmatch)
"AD" = (
/obj/structure/sign/departments/restroom/directional/west,
/turf/open/floor/engine/cult,
/area/deathmatch)
"Bm" = (
/obj/effect/landmark/deathmatch_player_spawn,
/turf/open/floor/plastic,
/area/deathmatch)
"BJ" = (
/obj/structure/window/green_glass_pane,
/turf/open/floor/engine/cult,
/area/deathmatch)
"Cb" = (
/obj/effect/turf_decal/tile/bar/opposingcorners,
/obj/structure/table/wood,
/obj/item/reagent_containers/condiment/saltshaker{
	pixel_x = 12;
	pixel_y = 11
	},
/obj/item/reagent_containers/condiment/peppermill{
	pixel_x = 12;
	pixel_y = 4
	},
/obj/item/plate{
	pixel_y = 4;
	pixel_x = -2
	},
/obj/item/trash/candle{
	pixel_x = 7;
	pixel_y = 1
	},
/turf/open/floor/iron,
/area/deathmatch)
"Cj" = (
/obj/structure/table,
/obj/item/clothing/ears/earmuffs{
	pixel_y = 14;
	pixel_x = 4
	},
/obj/item/toy/gun{
	pixel_y = 2;
	pixel_x = -3
	},
/obj/item/clothing/head/wizard/red{
	pixel_x = 6;
	pixel_y = -10
	},
/turf/open/floor/engine/cult,
/area/deathmatch)
"Cq" = (
/turf/open/floor/carpet/red,
/area/deathmatch)
"CM" = (
/obj/structure/railing/corner,
/obj/structure/railing/corner{
	dir = 8
	},
/obj/structure/railing/corner{
	dir = 4
	},
/obj/structure/railing/corner{
	dir = 1
	},
/obj/effect/light_emitter{
	set_cap = 2;
	light_color = "#DEEFFF";
	set_luminosity = 4
	},
/turf/open/floor/engine/cult,
/area/deathmatch)
"DK" = (
/obj/structure/railing{
	dir = 8
	},
/obj/structure/railing{
	dir = 8
	},
/obj/structure/railing{
	dir = 4
	},
/turf/open/floor/engine/cult,
/area/deathmatch)
"DW" = (
/obj/machinery/computer,
/turf/open/floor/carpet/red,
/area/deathmatch)
"Eh" = (
/obj/effect/light_emitter{
	set_cap = 2;
	light_color = "#DEEFFF";
	set_luminosity = 4
	},
/turf/open/floor/engine/cult,
/area/deathmatch)
"Er" = (
/obj/structure/table/wood,
/obj/item/storage/dice{
	icon_state = "magicdicebag";
	pixel_y = 12;
	pixel_x = -4
	},
/obj/item/dice/d20{
	pixel_y = 4;
	pixel_x = 2
	},
/turf/open/floor/engine/cult,
/area/deathmatch)
"Fb" = (
/obj/effect/turf_decal/stripes{
	dir = 1
	},
/turf/open/floor/engine/cult,
/area/deathmatch)
"Fm" = (
/obj/structure/chair/comfy/black{
	dir = 1
	},
/turf/open/floor/engine/cult,
/area/deathmatch)
"Fv" = (
/obj/structure/chair/wood/wings{
	dir = 4
	},
/turf/open/floor/engine/cult,
/area/deathmatch)
"Fx" = (
/obj/item/target,
/obj/structure/sign/flag/nanotrasen/directional/north,
/turf/open/floor/iron,
/area/deathmatch)
"FL" = (
/turf/open/floor/plastic,
/area/deathmatch)
"Ge" = (
/obj/item/flashlight/flare{
	pixel_x = -5;
	pixel_y = -12
	},
/turf/open/floor/engine/cult,
/area/deathmatch)
"Gv" = (
/obj/item/kirbyplants/organic/plant10{
	pixel_y = 2;
	pixel_x = 5
	},
/turf/open/floor/engine/cult,
/area/deathmatch)
"GC" = (
/obj/structure/bookcase/random,
/turf/open/floor/plastic,
/area/deathmatch)
"GZ" = (
/obj/structure/curtain,
/obj/machinery/shower/directional/north,
/obj/item/soap/syndie,
/turf/open/floor/noslip,
/area/deathmatch)
"Hf" = (
/obj/item/kirbyplants/organic/plant10{
	pixel_y = 1;
	pixel_x = -6
	},
/turf/open/floor/engine/cult,
/area/deathmatch)
"Hs" = (
/turf/template_noop,
/area/template_noop)
"HM" = (
/obj/structure/rack,
/obj/item/knife/ritual{
	pixel_y = 5
	},
/obj/item/staff{
	pixel_x = -4;
	pixel_y = 4
	},
/obj/item/staff/broom,
/turf/open/floor/engine/cult,
/area/deathmatch)
"HP" = (
/obj/structure/chair/comfy/black{
	dir = 1
	},
/turf/open/floor/carpet/red,
/area/deathmatch)
"HS" = (
/obj/structure/table/wood/fancy,
/obj/item/skub{
	pixel_y = 16
	},
/turf/open/floor/plastic,
/area/deathmatch)
"IE" = (
/obj/structure/table/wood,
/obj/item/clothing/suit/wizrobe/black{
	pixel_y = 3;
	pixel_x = -1
	},
/obj/item/clothing/head/wizard/black{
	pixel_y = 13;
	pixel_x = 6
	},
/turf/open/floor/engine/cult,
/area/deathmatch)
"IM" = (
/obj/item/kirbyplants/organic/plant10{
	pixel_y = 2;
	pixel_x = 5
	},
/turf/open/floor/carpet/purple,
/area/deathmatch)
"Jm" = (
/turf/closed/wall/wizarddeathmatch,
/area/deathmatch)
"Jo" = (
/obj/structure/toilet{
	dir = 4
	},
/turf/open/floor/plastic,
/area/deathmatch)
"Kr" = (
/obj/effect/landmark/deathmatch_player_spawn,
/turf/open/floor/engine/cult,
/area/deathmatch)
"KW" = (
/obj/effect/decal/cleanable/dirt/dust,
/turf/open/floor/engine/cult,
/area/deathmatch)
"Le" = (
/obj/structure/filingcabinet,
/obj/effect/decal/cleanable/dirt/dust,
/turf/open/floor/engine/cult,
/area/deathmatch)
"Nl" = (
/obj/machinery/power/shuttle_engine/heater{
	resistance_flags = 3
	},
/obj/structure/window/reinforced/spawner/directional/north{
	resistance_flags = 3
	},
/turf/open/floor/engine/cult,
/area/deathmatch)
"Nm" = (
/obj/item/kirbyplants/organic/plant10{
	pixel_y = 21;
	pixel_x = 6
	},
/turf/open/floor/engine/cult,
/area/deathmatch)
"Nt" = (
/obj/item/target{
	pixel_y = 11
	},
/obj/effect/turf_decal/stripes,
/turf/open/floor/iron,
/area/deathmatch)
"NN" = (
/obj/machinery/door/airlock/uranium/safe,
/turf/open/floor/engine/cult,
/area/deathmatch)
"NW" = (
/obj/structure/railing{
	dir = 4
	},
/obj/effect/turf_decal/stripes{
	dir = 1
	},
/turf/open/floor/engine/cult,
/area/deathmatch)
"Ok" = (
/obj/machinery/vending/cigarette,
/turf/open/floor/engine/cult,
/area/deathmatch)
"OD" = (
/obj/structure/filingcabinet,
/turf/open/floor/engine/cult,
/area/deathmatch)
"OK" = (
/obj/item/kirbyplants/organic/plant10{
	pixel_y = 21;
	pixel_x = 6
	},
/turf/open/floor/carpet/red,
/area/deathmatch)
"PD" = (
/obj/structure/table/wood,
/turf/open/floor/engine/cult,
/area/deathmatch)
"Qj" = (
/obj/structure/dresser,
/turf/open/floor/engine/cult,
/area/deathmatch)
"QH" = (
/obj/structure/table,
/obj/item/bikehorn/rubberducky{
	pixel_y = 5;
	pixel_x = -11
	},
/obj/item/clothing/head/wizard{
	pixel_y = 14;
	pixel_x = 4
	},
/turf/open/floor/plastic,
/area/deathmatch)
"QN" = (
/obj/structure/table/wood,
/obj/item/toy/figure/wizard{
	pixel_y = 2;
	pixel_x = -5
	},
/turf/open/floor/engine/cult,
/area/deathmatch)
"QT" = (
/obj/structure/mystery_box/wands,
/turf/open/floor/plastic,
/area/deathmatch)
"RB" = (
/obj/machinery/vending/snack,
/turf/open/floor/engine/cult,
/area/deathmatch)
"RI" = (
/obj/effect/decal/cleanable/cobweb,
/turf/open/floor/engine/cult,
/area/deathmatch)
"RT" = (
/obj/machinery/power/shuttle_engine/heater{
	resistance_flags = 3
	},
/obj/structure/window/reinforced/spawner/directional/north{
	resistance_flags = 3
	},
/turf/open/lava,
/area/deathmatch)
"Sa" = (
/turf/open/floor/grass,
/area/deathmatch)
"SK" = (
/obj/structure/flora/bush/fullgrass/style_random,
/turf/open/floor/grass,
/area/deathmatch)
"Th" = (
/obj/effect/turf_decal/tile/bar/opposingcorners,
/obj/structure/table/reinforced,
/obj/item/food/burger/rat{
	pixel_y = 9;
	pixel_x = -2
	},
/obj/item/food/bun{
	pixel_x = 8;
	pixel_y = 2
	},
/obj/effect/light_emitter{
	set_cap = 2;
	light_color = "#DEEFFF";
	set_luminosity = 4
	},
/turf/open/floor/iron,
/area/deathmatch)
"TS" = (
/obj/item/reagent_containers/cup/glass/bottle/beer{
	pixel_x = 11;
	pixel_y = 17
	},
/turf/open/floor/engine/cult,
/area/deathmatch)
"Vb" = (
/obj/structure/table/wood,
/obj/item/storage/photo_album,
/turf/open/floor/engine/cult,
/area/deathmatch)
"Vk" = (
/obj/machinery/door/window/left/directional/east,
/turf/open/floor/engine/cult,
/area/deathmatch)
"VM" = (
/obj/structure/table/wood/poker,
/obj/item/toy/cards/deck{
	pixel_y = 12;
	pixel_x = 8
	},
/turf/open/floor/engine/cult,
/area/deathmatch)
"Wl" = (
/obj/structure/railing{
	dir = 4
	},
/obj/effect/light_emitter{
	set_cap = 2;
	light_color = "#DEEFFF";
	set_luminosity = 4
	},
/turf/open/floor/engine/cult,
/area/deathmatch)
"WX" = (
/obj/machinery/vending/magivend,
/turf/open/floor/engine/cult,
/area/deathmatch)
"Xv" = (
/obj/structure/railing{
	layer = 3.1
	},
/obj/structure/railing{
	layer = 3.1;
	dir = 1
	},
/turf/open/floor/engine/cult,
/area/deathmatch)
"YP" = (
/obj/structure/closet/crate/coffin,
/obj/item/clothing/under/rank/civilian/curator,
/obj/item/food/meat/slab/human/mutant/skeleton,
/obj/item/bodypart/arm/left/skeleton,
/obj/item/bodypart/chest/skeleton,
/obj/item/bodypart/head/skeleton,
/obj/item/food/meat/slab/human/mutant/skeleton,
/obj/effect/decal/cleanable/cobweb/cobweb2,
/obj/effect/decal/cleanable/dirt/dust,
/turf/open/floor/engine/cult,
/area/deathmatch)
"YS" = (
/obj/effect/decal/cleanable/cobweb,
/obj/effect/decal/cleanable/dirt/dust,
/turf/open/floor/engine/cult,
/area/deathmatch)
"Zo" = (
/obj/structure/flora/bush/flowers_pp/style_random,
/turf/open/floor/grass,
/area/deathmatch)
"ZS" = (
/obj/structure/railing/corner/end/flip,
/turf/open/floor/iron,
/area/deathmatch)

(1,1,1) = {"
Hs
Hs
Hs
Hs
Hs
Hs
Hs
Hs
Hs
Hs
Hs
Hs
Hs
Hs
Hs
Hs
Hs
Hs
Hs
Hs
Hs
Hs
Hs
Hs
Hs
Hs
Hs
Hs
Hs
Hs
Hs
Hs
"}
(2,1,1) = {"
Hs
Hs
Hs
Hs
Hs
Hs
Hs
Hs
Hs
Hs
Hs
Hs
Hs
Hs
Hs
Hs
Hs
Hs
Hs
Hs
Hs
Hs
Hs
Hs
Hs
Hs
Hs
Hs
Hs
Hs
Hs
Hs
"}
(3,1,1) = {"
Hs
Hs
Hs
Hs
Hs
Hs
Hs
Hs
Hs
Hs
Hs
Hs
Hs
Hs
Hs
Hs
Hs
Hs
Hs
Hs
Hs
Hs
Hs
Hs
Hs
Hs
Hs
Hs
Hs
Hs
Hs
Hs
"}
(4,1,1) = {"
Hs
Hs
Hs
Hs
Hs
Hs
Hs
Hs
Hs
Hs
Hs
Hs
Hs
Hs
Hs
Hs
Hs
Hs
Hs
Hs
Hs
Hs
Hs
Hs
Hs
Hs
Hs
Hs
Hs
Hs
Hs
Hs
"}
(5,1,1) = {"
Hs
Hs
Hs
Hs
Hs
Hs
Hs
Hs
Jm
Jm
Jm
Jm
Jm
Hs
Hs
Hs
Hs
Hs
Hs
Hs
Hs
Hs
Hs
Hs
Hs
Hs
Hs
Hs
Hs
Hs
Hs
Hs
"}
(6,1,1) = {"
Hs
Hs
Hs
Hs
Hs
Hs
Hs
Jm
Jm
vR
lM
Qj
Jm
Jm
Jm
Jm
Jm
Jm
Jm
Jm
Jm
Jm
Jm
Jm
Jm
Jm
Jm
Jm
Hs
Hs
Hs
Hs
"}
(7,1,1) = {"
Hs
Hs
Hs
Hs
Hs
Hs
Jm
Jm
vR
ph
ph
ph
Jm
GC
Jo
HS
iQ
GZ
Jm
Fx
uz
ui
Fb
ph
ph
ph
ph
RT
bv
Hs
Hs
Hs
"}
(8,1,1) = {"
Hs
Hs
Hs
Hs
Hs
Hs
BJ
PD
iz
ph
ph
Gv
Jm
QT
FL
Bm
QH
uR
Jm
Fx
pv
Nt
Fb
Kr
ph
Eh
ph
RT
bv
Hs
Hs
Hs
"}
(9,1,1) = {"
Hs
Hs
Hs
Hs
Hs
Hs
BJ
ig
ph
Kr
qY
Jm
Jm
Jm
Jm
xk
FL
FL
Jm
Fx
ZS
mu
NW
Wl
Au
Vk
rj
RT
bv
Hs
Hs
Hs
"}
(10,1,1) = {"
Hs
Hs
Hs
Hs
Hs
Hs
Jm
HM
ph
Eh
Jm
Jm
nk
wl
Jm
Jm
nQ
Jm
Jm
Jm
Jm
Jm
pL
ph
ph
ph
Gv
Jm
Hs
Hs
Hs
Hs
"}
(11,1,1) = {"
Hs
Hs
Hs
BJ
BJ
BJ
Jm
zN
ph
ph
Jm
WX
ds
ds
Hf
Jm
ph
AD
Eh
Hf
vR
Jm
Jm
Cj
li
ph
Jm
Jm
Hs
Hs
Hs
Hs
"}
(12,1,1) = {"
Hs
Hs
BJ
BJ
IE
QN
Jm
oP
ph
ph
dj
ph
ds
ds
ph
NN
ph
ph
ph
ph
ph
vR
Jm
Jm
Jm
ay
Jm
Hs
Hs
Hs
Hs
Hs
"}
(13,1,1) = {"
Hs
Hs
BJ
mb
Fm
Hf
Jm
Jm
sf
Gv
Jm
vR
ds
ds
ph
Jm
Jm
Jm
Jm
Nm
ph
ph
vR
Jm
fI
Xv
Jm
Jm
Hs
Hs
Hs
Hs
"}
(14,1,1) = {"
Hs
Hs
BJ
mb
ph
ph
vh
Jm
Jm
Jm
Jm
vR
ds
ds
ph
Jm
xs
tL
Jm
Jm
ph
ph
vR
Jm
fI
Xv
fI
Jm
Jm
Hs
Hs
Hs
"}
(15,1,1) = {"
Hs
Hs
BJ
on
Cq
Cq
Cq
Cq
Cq
Cq
Cq
Cq
ds
ds
Cq
gn
Zo
Sa
xs
Jm
OK
Cq
Cq
Jm
fI
Xv
fI
fI
RT
bv
Hs
Hs
"}
(16,1,1) = {"
Hs
Hs
BJ
DW
HP
iL
nx
Cq
Cq
Cq
iL
Cq
ds
ds
Cq
gn
Sa
kl
wt
Jm
nx
iL
Cq
jb
DK
CM
rD
ok
Nl
bv
Hs
Hs
"}
(17,1,1) = {"
Hs
Hs
BJ
on
Cq
Cq
Cq
Cq
Cq
Cq
Cq
Cq
ds
ds
Cq
gn
Sa
pV
SK
Jm
pe
Cq
Cq
Jm
fI
Xv
fI
fI
RT
bv
Hs
Hs
"}
(18,1,1) = {"
Hs
Hs
BJ
mb
ph
ph
Ok
Jm
Jm
Jm
Jm
vR
ds
ds
ph
Jm
SK
eo
Jm
Jm
ph
ph
vR
Jm
fI
Xv
fI
Jm
Jm
Hs
Hs
Hs
"}
(19,1,1) = {"
Hs
Hs
BJ
mb
Fm
Gv
Jm
Jm
Er
vh
Jm
vR
ds
ds
ph
Jm
Jm
Jm
Jm
hk
ph
ph
vR
Jm
fI
Xv
Jm
Jm
Hs
Hs
Hs
Hs
"}
(20,1,1) = {"
Hs
Hs
BJ
BJ
nV
Vb
Jm
zz
ph
ph
NN
ph
ds
ds
ph
NN
ph
ph
ph
ph
ph
vR
Jm
Jm
Jm
hg
Jm
Hs
Hs
Hs
Hs
Hs
"}
(21,1,1) = {"
Hs
Hs
Hs
BJ
BJ
BJ
Jm
PD
ph
ph
Jm
RB
ds
ds
Gv
Jm
ph
ph
Eh
Gv
vh
Jm
Jm
YS
KW
Ge
Jm
Jm
Hs
Hs
Hs
Hs
"}
(22,1,1) = {"
Hs
Hs
Hs
Hs
Hs
Hs
Jm
uM
ph
Eh
Jm
Jm
nk
IM
Jm
Jm
jV
Jm
Jm
Jm
Jm
Jm
RI
ph
vR
ph
lO
Jm
Hs
Hs
Hs
Hs
"}
(23,1,1) = {"
Hs
Hs
Hs
Hs
Hs
Hs
BJ
zO
ph
Kr
ph
Jm
Jm
Jm
Jm
wL
js
fH
Jm
aT
ph
KW
ph
hK
vR
KW
ez
RT
bv
Hs
Hs
Hs
"}
(24,1,1) = {"
Hs
Hs
Hs
Hs
Hs
Hs
BJ
bg
ph
ph
Fv
Hf
Jm
gR
js
jg
js
Th
Jm
jm
Eh
vR
KW
Kr
KW
Eh
vv
RT
bv
Hs
Hs
Hs
"}
(25,1,1) = {"
Hs
Hs
Hs
Hs
Hs
Hs
Jm
Jm
TS
yA
VM
cU
Jm
wd
gr
Cb
iZ
ue
Jm
YP
KW
KW
ph
Le
OD
co
jM
RT
bv
Hs
Hs
Hs
"}
(26,1,1) = {"
Hs
Hs
Hs
Hs
Hs
Hs
Hs
Jm
Jm
ph
bb
Gv
Jm
Jm
Jm
Jm
Jm
Jm
Jm
Jm
Jm
Jm
Jm
Jm
Jm
Jm
Jm
Jm
Hs
Hs
Hs
Hs
"}
(27,1,1) = {"
Hs
Hs
Hs
Hs
Hs
Hs
Hs
Hs
Jm
Jm
Jm
Jm
Jm
Hs
Hs
Hs
Hs
Hs
Hs
Hs
Hs
Hs
Hs
Hs
Hs
Hs
Hs
Hs
Hs
Hs
Hs
Hs
"}
(28,1,1) = {"
Hs
Hs
Hs
Hs
Hs
Hs
Hs
Hs
Hs
Hs
Hs
Hs
Hs
Hs
Hs
Hs
Hs
Hs
Hs
Hs
Hs
Hs
Hs
Hs
Hs
Hs
Hs
Hs
Hs
Hs
Hs
Hs
"}
(29,1,1) = {"
Hs
Hs
Hs
Hs
Hs
Hs
Hs
Hs
Hs
Hs
Hs
Hs
Hs
Hs
Hs
Hs
Hs
Hs
Hs
Hs
Hs
Hs
Hs
Hs
Hs
Hs
Hs
Hs
Hs
Hs
Hs
Hs
"}
(30,1,1) = {"
Hs
Hs
Hs
Hs
Hs
Hs
Hs
Hs
Hs
Hs
Hs
Hs
Hs
Hs
Hs
Hs
Hs
Hs
Hs
Hs
Hs
Hs
Hs
Hs
Hs
Hs
Hs
Hs
Hs
Hs
Hs
Hs
"}
(31,1,1) = {"
Hs
Hs
Hs
Hs
Hs
Hs
Hs
Hs
Hs
Hs
Hs
Hs
Hs
Hs
Hs
Hs
Hs
Hs
Hs
Hs
Hs
Hs
Hs
Hs
Hs
Hs
Hs
Hs
Hs
Hs
Hs
Hs
"}
(32,1,1) = {"
Hs
Hs
Hs
Hs
Hs
Hs
Hs
Hs
Hs
Hs
Hs
Hs
Hs
Hs
Hs
Hs
Hs
Hs
Hs
Hs
Hs
Hs
Hs
Hs
Hs
Hs
Hs
Hs
Hs
Hs
Hs
Hs
"}
