//MAP CONVERTED BY dmm2tgm.py THIS HEADER COMMENT PREVENTS RECONVERSION, DO NOT REMOVE
"a" = (
/obj/machinery/airalarm/directional/west,
/obj/structure/rack,
/obj/effect/spawner/armory_spawn/shotguns,
/obj/effect/turf_decal/bot_white,
/turf/open/floor/iron/dark/textured_large,
/area/station/security/armory)
"b" = (
/obj/item/radio/intercom/directional/west,
/obj/machinery/light/small/directional/west,
/obj/structure/guncase/ecase{
	open = 0;
	anchored = 1
	},
/obj/effect/spawner/armory_spawn/mod_lasers_big,
/obj/effect/spawner/armory_spawn/mod_lasers_small,
/obj/effect/turf_decal/bot_white,
/turf/open/floor/iron/dark/textured_large,
/area/station/security/armory)
"r" = (
/obj/structure/rack,
/obj/effect/spawner/armory_spawn/smg,
/obj/effect/spawner/random/armory/dragnet,
/obj/structure/sign/poster/official/random/directional/west,
/obj/effect/turf_decal/bot_white,
/turf/open/floor/iron/dark/textured_large,
/area/station/security/armory)

(1,1,1) = {"
b
r
a
"}
