//MAP CONVERTED BY dmm2tgm.py THIS HEADER COMMENT PREVENTS RECONVERSION, DO NOT REMOVE
"a" = (
/turf/template_noop,
/area/template_noop)
"k" = (
/obj/machinery/power/apc/auto_name/directional/east,
/obj/structure/cable,
/obj/structure/extinguisher_cabinet/directional/south,
/obj/effect/turf_decal/tile/dark_green{
	dir = 4
	},
/obj/structure/closet/secure_closet/security/service,
/turf/open/floor/iron/checker,
/area/station/service/bar/backroom)
"B" = (
/obj/structure/table/wood,
/obj/item/hand_labeler{
	pixel_y = -12
	},
/obj/machinery/newscaster/directional/west,
/obj/effect/turf_decal/tile/dark_green{
	dir = 4
	},
/obj/item/wrench{
	pixel_x = -3;
	pixel_y = 5
	},
/obj/item/crowbar/red{
	pixel_x = 7;
	pixel_y = 5
	},
/turf/open/floor/iron/checker,
/area/station/service/bar/backroom)

(1,1,1) = {"
a
B
a
a
"}
(2,1,1) = {"
a
a
a
a
"}
(3,1,1) = {"
a
a
a
k
"}
