//MAP CONVERTED BY dmm2tgm.py THIS HEADER COMMENT PREVENTS RECONVERSION, DO NOT REMOVE
"a" = (
/turf/closed/wall/r_wall,
/area/station/hallway/secondary/entry)
"b" = (
/obj/structure/flora/bush/ferny/style_random,
/obj/structure/flora/bush/fullgrass/style_random,
/obj/structure/flora/bush/pale/style_random,
/obj/machinery/atmospherics/pipe/smart/manifold4w/supply/hidden/layer4,
/obj/machinery/atmospherics/pipe/smart/manifold4w/scrubbers/hidden/layer2,
/obj/structure/cable,
/turf/open/floor/grass,
/area/station/hallway/secondary/entry)
"c" = (
/obj/machinery/atmospherics/pipe/smart/manifold4w/scrubbers/hidden/layer2,
/obj/effect/turf_decal/tile/dark_blue{
	dir = 1
	},
/obj/effect/turf_decal/tile/dark_blue,
/obj/structure/disposalpipe/segment{
	dir = 10
	},
/turf/open/floor/iron/white,
/area/station/hallway/secondary/entry)
"d" = (
/obj/structure/railing{
	dir = 6
	},
/obj/effect/turf_decal/siding/brown{
	dir = 6
	},
/obj/effect/turf_decal/tile/dark_blue{
	dir = 1
	},
/obj/effect/turf_decal/tile/dark_blue,
/turf/open/floor/iron/white,
/area/station/hallway/secondary/entry)
"e" = (
/obj/effect/turf_decal/delivery,
/obj/machinery/vending/coffee,
/turf/open/floor/iron/dark,
/area/station/hallway/secondary/entry)
"f" = (
/obj/machinery/door/airlock/external{
	name = "Arrival Airlock";
	space_dir = 4
	},
/obj/effect/mapping_helpers/airlock/cyclelink_helper{
	dir = 8
	},
/turf/open/floor/plating,
/area/station/hallway/secondary/entry)
"g" = (
/obj/docking_port/stationary{
	dir = 2;
	dwidth = 1;
	height = 13;
	shuttle_id = "arrivals_stationary";
	name = "arrivals";
	roundstart_template = null;
	width = 5
	},
/turf/open/space/basic,
/area/space)
"h" = (
/turf/open/space/basic,
/area/space)
"i" = (
/obj/structure/flora/bush/fullgrass/style_random,
/obj/structure/flora/bush/pale/style_random,
/obj/structure/cable,
/turf/open/floor/grass,
/area/station/hallway/secondary/entry)
"j" = (
/obj/structure/cable,
/obj/effect/turf_decal/tile/dark_blue{
	dir = 1
	},
/obj/effect/turf_decal/tile/dark_blue,
/turf/open/floor/iron/white,
/area/station/hallway/secondary/entry)
"k" = (
/obj/machinery/atmospherics/pipe/smart/manifold4w/scrubbers/hidden/layer2,
/obj/effect/turf_decal/tile/dark_blue{
	dir = 1
	},
/obj/effect/turf_decal/tile/dark_blue,
/obj/effect/turf_decal/stripes/corner{
	dir = 8
	},
/obj/structure/disposalpipe/segment,
/turf/open/floor/iron/white,
/area/station/hallway/secondary/entry)
"l" = (
/obj/effect/turf_decal/delivery,
/obj/effect/spawner/random/entertainment/arcade{
	dir = 4
	},
/turf/open/floor/iron/dark,
/area/station/hallway/secondary/entry)
"m" = (
/obj/effect/turf_decal/stripes/line{
	dir = 4
	},
/obj/machinery/atmospherics/pipe/smart/manifold4w/supply/hidden/layer4,
/obj/machinery/atmospherics/pipe/smart/manifold4w/scrubbers/hidden/layer2,
/obj/structure/cable,
/obj/effect/turf_decal/tile/dark_blue{
	dir = 1
	},
/obj/effect/turf_decal/tile/dark_blue,
/turf/open/floor/iron/white,
/area/station/hallway/secondary/entry)
"n" = (
/obj/structure/flora/bush/ferny/style_random,
/obj/structure/flora/bush/fullgrass/style_random,
/obj/machinery/atmospherics/pipe/smart/manifold4w/scrubbers/hidden/layer2,
/obj/machinery/atmospherics/pipe/smart/manifold4w/supply/hidden/layer4,
/obj/structure/cable,
/obj/machinery/light/floor,
/obj/machinery/camera/autoname/directional/south,
/turf/open/floor/grass,
/area/station/hallway/secondary/entry)
"o" = (
/obj/structure/flora/bush/ferny/style_random,
/obj/structure/flora/bush/fullgrass/style_random,
/obj/structure/flora/bush/flowers_br/style_random,
/obj/machinery/atmospherics/pipe/smart/manifold4w/supply/hidden/layer4,
/obj/machinery/atmospherics/pipe/smart/manifold4w/scrubbers/hidden/layer2,
/turf/open/floor/grass,
/area/station/hallway/secondary/entry)
"p" = (
/obj/machinery/atmospherics/pipe/smart/manifold4w/supply/hidden/layer4,
/obj/machinery/atmospherics/pipe/smart/manifold4w/scrubbers/hidden/layer2,
/obj/structure/cable,
/obj/effect/turf_decal/tile/dark_blue{
	dir = 1
	},
/obj/effect/turf_decal/tile/dark_blue,
/obj/effect/turf_decal/stripes/corner,
/turf/open/floor/iron/white,
/area/station/hallway/secondary/entry)
"q" = (
/obj/effect/turf_decal/tile/dark_blue{
	dir = 1
	},
/obj/effect/turf_decal/tile/dark_blue,
/turf/open/floor/iron/white,
/area/station/hallway/secondary/entry)
"r" = (
/obj/machinery/door/airlock/external{
	name = "Arrival Airlock";
	space_dir = 8
	},
/obj/effect/mapping_helpers/airlock/cyclelink_helper{
	dir = 4
	},
/turf/open/floor/plating,
/area/station/hallway/secondary/entry)
"s" = (
/obj/machinery/atmospherics/pipe/smart/manifold4w/scrubbers/hidden/layer2,
/obj/structure/disposalpipe/segment{
	dir = 5
	},
/obj/effect/turf_decal/tile/dark_blue{
	dir = 1
	},
/obj/effect/turf_decal/tile/dark_blue,
/obj/effect/turf_decal/stripes/line{
	dir = 8
	},
/turf/open/floor/iron/white,
/area/station/hallway/secondary/entry)
"t" = (
/obj/effect/turf_decal/stripes/line{
	dir = 8
	},
/obj/machinery/atmospherics/pipe/smart/manifold4w/scrubbers/hidden/layer2,
/obj/effect/turf_decal/tile/dark_blue{
	dir = 1
	},
/obj/effect/turf_decal/tile/dark_blue,
/turf/open/floor/iron/white,
/area/station/hallway/secondary/entry)
"u" = (
/obj/machinery/atmospherics/pipe/smart/manifold4w/scrubbers/hidden/layer2,
/obj/effect/turf_decal/tile/dark_blue{
	dir = 1
	},
/obj/effect/turf_decal/tile/dark_blue,
/obj/effect/turf_decal/stripes/corner{
	dir = 8
	},
/obj/structure/disposalpipe/segment{
	dir = 4
	},
/turf/open/floor/iron/white,
/area/station/hallway/secondary/entry)
"v" = (
/obj/structure/railing/corner,
/obj/effect/turf_decal/siding/brown/corner,
/obj/machinery/atmospherics/components/unary/vent_pump/on/layer4,
/obj/effect/turf_decal/tile/dark_blue{
	dir = 1
	},
/obj/effect/turf_decal/tile/dark_blue,
/turf/open/floor/iron/white,
/area/station/hallway/secondary/entry)
"w" = (
/obj/structure/flora/bush/fullgrass/style_random,
/obj/structure/flora/bush/pale/style_random,
/obj/structure/flora/bush/flowers_br/style_random,
/obj/machinery/atmospherics/pipe/smart/manifold4w/scrubbers/hidden/layer2,
/obj/machinery/atmospherics/pipe/smart/manifold4w/supply/hidden/layer4,
/obj/structure/cable,
/turf/open/floor/grass,
/area/station/hallway/secondary/entry)
"x" = (
/obj/structure/railing{
	dir = 10
	},
/obj/effect/turf_decal/siding/brown{
	dir = 10
	},
/obj/structure/cable,
/obj/structure/disposalpipe/segment,
/obj/effect/turf_decal/tile/dark_blue{
	dir = 1
	},
/obj/effect/turf_decal/tile/dark_blue,
/turf/open/floor/iron/white,
/area/station/hallway/secondary/entry)
"y" = (
/obj/structure/flora/bush/flowers_br/style_random,
/obj/structure/flora/bush/fullgrass/style_random,
/obj/structure/cable,
/turf/open/floor/grass,
/area/station/hallway/secondary/entry)
"z" = (
/turf/open/floor/plating,
/area/station/hallway/secondary/entry)
"A" = (
/obj/effect/turf_decal/stripes/line{
	dir = 6
	},
/obj/effect/turf_decal/tile/dark_blue{
	dir = 1
	},
/obj/effect/turf_decal/tile/dark_blue,
/turf/open/floor/iron/white,
/area/station/hallway/secondary/entry)
"B" = (
/obj/effect/turf_decal/delivery,
/obj/effect/spawner/random/entertainment/arcade{
	dir = 8
	},
/turf/open/floor/iron/dark,
/area/station/hallway/secondary/entry)
"C" = (
/obj/structure/flora/bush/pale/style_random,
/obj/structure/flora/bush/fullgrass/style_random,
/obj/effect/landmark/start/hangover,
/turf/open/floor/grass,
/area/station/hallway/secondary/entry)
"D" = (
/obj/structure/flora/bush/pale/style_random,
/obj/structure/flora/bush/fullgrass/style_random,
/obj/structure/flora/bush/ferny/style_random,
/obj/machinery/atmospherics/pipe/smart/manifold4w/supply/hidden/layer4,
/obj/machinery/atmospherics/pipe/smart/manifold4w/scrubbers/hidden/layer2,
/obj/effect/landmark/start/hangover,
/turf/open/floor/grass,
/area/station/hallway/secondary/entry)
"E" = (
/obj/structure/flora/bush/ferny/style_random,
/obj/structure/flora/bush/fullgrass/style_random,
/obj/structure/flora/bush/ferny/style_random,
/obj/structure/cable,
/turf/open/floor/grass,
/area/station/hallway/secondary/entry)
"F" = (
/obj/effect/turf_decal/stripes/line{
	dir = 10
	},
/obj/effect/turf_decal/tile/dark_blue{
	dir = 1
	},
/obj/effect/turf_decal/tile/dark_blue,
/obj/machinery/computer/shuttle/arrivals/recall{
	dir = 4
	},
/obj/machinery/status_display/shuttle/directional/west,
/turf/open/floor/iron/white,
/area/station/hallway/secondary/entry)
"G" = (
/obj/structure/flora/bush/fullgrass/style_random,
/obj/structure/flora/bush/ferny/style_random,
/obj/machinery/atmospherics/pipe/smart/manifold4w/supply/hidden/layer4,
/obj/machinery/atmospherics/pipe/smart/manifold4w/scrubbers/hidden/layer2,
/obj/structure/disposalpipe/segment{
	dir = 5
	},
/turf/open/floor/grass,
/area/station/hallway/secondary/entry)
"H" = (
/obj/structure/flora/bush/fullgrass/style_random,
/obj/structure/flora/bush/ferny/style_random,
/turf/open/floor/grass,
/area/station/hallway/secondary/entry)
"I" = (
/obj/structure/railing{
	dir = 8
	},
/obj/effect/turf_decal/siding/brown{
	dir = 8
	},
/obj/machinery/atmospherics/pipe/smart/manifold4w/supply/hidden/layer4,
/obj/machinery/atmospherics/pipe/smart/manifold4w/scrubbers/hidden/layer2,
/obj/effect/turf_decal/tile/dark_blue,
/obj/effect/turf_decal/stripes/line,
/obj/structure/disposalpipe/segment{
	dir = 4
	},
/turf/open/floor/iron/white,
/area/station/hallway/secondary/entry)
"J" = (
/obj/effect/turf_decal/delivery,
/obj/effect/spawner/random/vending/snackvend,
/turf/open/floor/iron/dark,
/area/station/hallway/secondary/entry)
"K" = (
/obj/effect/turf_decal/delivery,
/obj/structure/table,
/obj/effect/spawner/random/food_or_drink,
/turf/open/floor/iron/dark,
/area/station/hallway/secondary/entry)
"L" = (
/obj/effect/spawner/structure/window/reinforced,
/turf/open/floor/plating,
/area/station/hallway/secondary/entry)
"M" = (
/obj/effect/turf_decal/stripes/line{
	dir = 4
	},
/obj/machinery/atmospherics/pipe/smart/manifold4w/scrubbers/hidden/layer2,
/obj/effect/turf_decal/tile/dark_blue{
	dir = 1
	},
/obj/effect/turf_decal/tile/dark_blue,
/turf/open/floor/iron/white,
/area/station/hallway/secondary/entry)
"N" = (
/obj/structure/flora/bush/pale/style_random,
/obj/structure/flora/bush/fullgrass/style_random,
/obj/machinery/atmospherics/pipe/smart/manifold4w/supply/hidden/layer4,
/obj/machinery/atmospherics/pipe/smart/manifold4w/scrubbers/hidden/layer2,
/obj/structure/cable,
/turf/open/floor/grass,
/area/station/hallway/secondary/entry)
"O" = (
/obj/machinery/atmospherics/pipe/smart/manifold4w/supply/hidden/layer4,
/obj/machinery/atmospherics/pipe/smart/manifold4w/scrubbers/hidden/layer2,
/obj/structure/cable,
/obj/effect/turf_decal/tile/dark_blue{
	dir = 1
	},
/obj/effect/turf_decal/tile/dark_blue,
/turf/open/floor/iron/white,
/area/station/hallway/secondary/entry)
"P" = (
/obj/machinery/door/airlock/external{
	name = "Arrival Airlock"
	},
/obj/effect/mapping_helpers/airlock/cyclelink_helper{
	dir = 4
	},
/turf/open/floor/plating,
/area/station/hallway/secondary/entry)
"Q" = (
/obj/machinery/atmospherics/pipe/smart/manifold4w/supply/hidden/layer4,
/obj/machinery/atmospherics/pipe/smart/manifold4w/scrubbers/hidden/layer2,
/obj/structure/cable,
/obj/effect/turf_decal/tile/dark_blue{
	dir = 1
	},
/obj/effect/turf_decal/tile/dark_blue,
/obj/effect/turf_decal/stripes/line{
	dir = 4
	},
/turf/open/floor/iron/white,
/area/station/hallway/secondary/entry)
"R" = (
/obj/structure/flora/bush/fullgrass/style_random,
/obj/structure/flora/bush/flowers_br/style_random,
/obj/machinery/atmospherics/pipe/smart/manifold4w/supply/hidden/layer4,
/obj/machinery/atmospherics/pipe/smart/manifold4w/scrubbers/hidden/layer2,
/obj/structure/cable,
/turf/open/floor/grass,
/area/station/hallway/secondary/entry)
"S" = (
/obj/structure/flora/bush/pale/style_random,
/obj/structure/flora/bush/fullgrass/style_random,
/obj/machinery/atmospherics/pipe/smart/manifold4w/supply/hidden/layer4,
/obj/machinery/atmospherics/pipe/smart/manifold4w/scrubbers/hidden/layer2,
/turf/open/floor/grass,
/area/station/hallway/secondary/entry)
"T" = (
/obj/structure/flora/bush/flowers_br/style_random,
/obj/structure/flora/bush/pale/style_random,
/obj/structure/flora/bush/fullgrass/style_random,
/obj/machinery/atmospherics/pipe/smart/manifold4w/supply/hidden/layer4,
/obj/machinery/atmospherics/pipe/smart/manifold4w/scrubbers/hidden/layer2,
/obj/structure/cable,
/turf/open/floor/grass,
/area/station/hallway/secondary/entry)
"U" = (
/obj/structure/flora/bush/flowers_br/style_random,
/obj/structure/flora/bush/fullgrass/style_random,
/turf/open/floor/grass,
/area/station/hallway/secondary/entry)
"V" = (
/obj/effect/turf_decal/delivery,
/obj/effect/spawner/random/vending/colavend,
/turf/open/floor/iron/dark,
/area/station/hallway/secondary/entry)
"W" = (
/obj/structure/railing/corner{
	dir = 8
	},
/obj/effect/turf_decal/siding/brown/corner{
	dir = 8
	},
/obj/structure/cable,
/obj/machinery/atmospherics/components/unary/vent_pump/on/layer4,
/obj/effect/turf_decal/tile/dark_blue{
	dir = 1
	},
/obj/effect/turf_decal/tile/dark_blue,
/turf/open/floor/iron/white,
/area/station/hallway/secondary/entry)
"X" = (
/obj/structure/railing{
	dir = 4
	},
/obj/effect/turf_decal/siding/brown{
	dir = 4
	},
/obj/machinery/atmospherics/pipe/smart/manifold4w/supply/hidden/layer4,
/obj/machinery/atmospherics/pipe/smart/manifold4w/scrubbers/hidden/layer2,
/obj/structure/cable,
/obj/effect/turf_decal/tile/dark_blue{
	dir = 1
	},
/obj/effect/turf_decal/stripes/line,
/turf/open/floor/iron/white,
/area/station/hallway/secondary/entry)
"Y" = (
/obj/machinery/door/airlock/external{
	name = "Arrival Airlock"
	},
/obj/effect/mapping_helpers/airlock/cyclelink_helper{
	dir = 8
	},
/turf/open/floor/plating,
/area/station/hallway/secondary/entry)
"Z" = (
/obj/effect/turf_decal/delivery,
/obj/structure/table,
/obj/effect/spawner/random/entertainment/cigarette_pack,
/turf/open/floor/iron/dark,
/area/station/hallway/secondary/entry)

(1,1,1) = {"
q
O
p
Q
m
m
m
M
M
M
"}
(2,1,1) = {"
q
p
A
J
Z
e
L
P
L
B
"}
(3,1,1) = {"
v
X
a
a
L
a
L
z
L
a
"}
(4,1,1) = {"
d
T
L
h
h
h
L
f
L
h
"}
(5,1,1) = {"
H
N
L
h
h
h
h
h
h
h
"}
(6,1,1) = {"
U
b
L
h
h
h
h
h
h
h
"}
(7,1,1) = {"
C
R
L
h
h
h
h
h
h
h
"}
(8,1,1) = {"
w
n
a
h
h
h
h
h
h
h
"}
(9,1,1) = {"
y
D
L
h
h
h
h
h
h
h
"}
(10,1,1) = {"
E
S
L
h
h
g
h
h
h
h
"}
(11,1,1) = {"
i
o
L
h
h
h
h
h
h
h
"}
(12,1,1) = {"
x
G
L
h
h
h
L
r
L
h
"}
(13,1,1) = {"
W
I
a
a
L
a
L
z
L
a
"}
(14,1,1) = {"
j
u
F
V
K
e
L
Y
L
l
"}
(15,1,1) = {"
j
c
k
s
t
t
t
t
t
t
"}
