//MAP CONVERTED BY dmm2tgm.py THIS HEADER COMMENT PREVENTS RECONVERSION, DO NOT REMOVE
"b" = (
/obj/machinery/atmospherics/pipe/smart/manifold4w/supply/hidden/layer4,
/obj/structure/cable,
/obj/effect/turf_decal/siding/wood{
	dir = 4
	},
/turf/open/floor/wood/wood_5,
/area/station/command/heads_quarters/nt_rep)
"c" = (
/obj/structure/chair/office{
	dir = 8
	},
/obj/effect/landmark/start/nanotrasen_consultant,
/obj/machinery/light_switch/directional/east,
/turf/open/floor/carpet/executive,
/area/station/command/heads_quarters/nt_rep)
"d" = (
/obj/machinery/camera/autoname/directional/east,
/obj/machinery/airalarm/directional/east,
/obj/machinery/photocopier/prebuilt,
/turf/open/floor/carpet/executive,
/area/station/command/heads_quarters/nt_rep)
"f" = (
/obj/structure/sign/directions/science{
	pixel_y = -8
	},
/obj/structure/sign/directions/security{
	dir = 8;
	pixel_y = -2
	},
/obj/structure/sign/directions/vault{
	dir = 1;
	pixel_y = 4
	},
/obj/structure/sign/directions/evac{
	dir = 1;
	pixel_y = 10
	},
/turf/closed/wall/r_wall,
/area/station/command/heads_quarters/nt_rep)
"h" = (
/obj/structure/table/wood,
/obj/item/paper_bin{
	pixel_y = 4
	},
/obj/item/pen/fountain,
/turf/open/floor/carpet/executive,
/area/station/command/heads_quarters/nt_rep)
"i" = (
/turf/closed/wall/r_wall,
/area/station/command/heads_quarters/nt_rep)
"j" = (
/obj/machinery/firealarm/directional/west,
/turf/template_noop,
/area/template_noop)
"r" = (
/obj/machinery/status_display/ai/directional/east,
/obj/effect/turf_decal/siding/wood,
/obj/machinery/button/polarizer{
	id = "catwalkntrep";
	pixel_y = 24;
	name = "Window Privacy";
	dir = 1
	},
/obj/effect/turf_decal/siding/wood{
	dir = 1
	},
/obj/machinery/button/ticket_machine{
	pixel_y = 24;
	pixel_x = 10;
	id = "ticket_machine_ntc"
	},
/turf/open/floor/wood/wood_5,
/area/station/command/heads_quarters/nt_rep)
"s" = (
/obj/machinery/atmospherics/pipe/smart/manifold4w/supply/hidden/layer4,
/obj/machinery/atmospherics/pipe/smart/manifold4w/scrubbers/hidden/layer2,
/obj/effect/turf_decal/siding/wood{
	dir = 4
	},
/obj/structure/chair/office{
	dir = 4
	},
/turf/open/floor/wood/wood_5,
/area/station/command/heads_quarters/nt_rep)
"v" = (
/turf/template_noop,
/area/template_noop)
"x" = (
/obj/structure/stairs/east,
/turf/open/floor/iron/stairs/medium{
	dir = 8
	},
/area/station/command/heads_quarters/nt_rep)
"y" = (
/obj/effect/turf_decal/siding/wood{
	dir = 4
	},
/obj/machinery/atmospherics/components/unary/vent_scrubber/on/layer2{
	dir = 1
	},
/obj/item/kirbyplants/random,
/obj/structure/cable,
/turf/open/floor/wood/wood_5,
/area/station/command/heads_quarters/nt_rep)
"A" = (
/obj/structure/table/wood,
/obj/machinery/fax{
	fax_name = "Nanotrasen Consultant's Office";
	name = "Nanotrasen Consultant's Fax Machine"
	},
/turf/open/floor/carpet/executive,
/area/station/command/heads_quarters/nt_rep)
"B" = (
/obj/machinery/power/apc/auto_name/directional/north,
/obj/structure/cable,
/turf/open/floor/iron/stairs/medium{
	dir = 8
	},
/area/station/command/heads_quarters/nt_rep)
"D" = (
/obj/machinery/atmospherics/components/unary/vent_pump/on/layer4,
/obj/structure/cable,
/obj/structure/railing/corner/end/flip{
	dir = 4
	},
/obj/effect/turf_decal/siding/wood/corner,
/obj/effect/turf_decal/siding/wood{
	dir = 1
	},
/obj/machinery/firealarm/directional/west,
/turf/open/floor/wood/wood_5,
/area/station/command/heads_quarters/nt_rep)
"H" = (
/obj/structure/sign/plaques/kiddie/perfect_man{
	pixel_x = 32;
	dir = 4
	},
/obj/machinery/light/directional/east,
/turf/open/floor/carpet/executive,
/area/station/command/heads_quarters/nt_rep)
"I" = (
/obj/effect/spawner/structure/window/reinforced{
	polarizer_id = "catwalkntrep"
	},
/obj/structure/cable,
/turf/open/floor/plating,
/area/station/command/heads_quarters/nt_rep)
"M" = (
/turf/closed/wall,
/area/station/command/heads_quarters/nt_rep)
"P" = (
/obj/machinery/ticket_machine/directional/east,
/turf/open/floor/iron/edge{
	dir = 4
	},
/area/station/hallway/primary/central)
"Q" = (
/obj/structure/table/wood,
/obj/item/stamp{
	pixel_x = -2;
	pixel_y = 6
	},
/obj/item/stamp/denied{
	pixel_x = 8;
	pixel_y = 6
	},
/obj/item/stamp/centcom{
	pixel_x = 4
	},
/turf/open/floor/carpet/executive,
/area/station/command/heads_quarters/nt_rep)
"Y" = (
/obj/machinery/atmospherics/pipe/smart/manifold4w/supply/hidden/layer4,
/obj/machinery/atmospherics/pipe/smart/manifold4w/scrubbers/hidden/layer2,
/obj/structure/cable,
/obj/machinery/door/airlock/corporate{
	name = "NT Consultant's Office"
	},
/obj/effect/landmark/navigate_destination,
/obj/effect/mapping_helpers/airlock/access/all/cent_com/rep_door,
/obj/machinery/door/firedoor,
/turf/open/floor/iron,
/area/station/command/heads_quarters/nt_rep)
"Z" = (
/obj/structure/railing{
	dir = 1
	},
/obj/machinery/holopad,
/obj/effect/turf_decal/siding/wood{
	dir = 1
	},
/obj/effect/turf_decal/siding/wood,
/turf/open/floor/wood/wood_5,
/area/station/command/heads_quarters/nt_rep)

(1,1,1) = {"
v
v
v
v
v
P
"}
(2,1,1) = {"
i
i
I
Y
I
i
"}
(3,1,1) = {"
B
D
b
s
y
I
"}
(4,1,1) = {"
x
Z
Q
h
A
I
"}
(5,1,1) = {"
M
r
H
c
d
i
"}
(6,1,1) = {"
i
i
i
i
i
f
"}
(7,1,1) = {"
v
v
j
v
v
v
"}
