//MAP CONVERTED BY dmm2tgm.py THIS HEADER COMMENT PREVENTS RECONVERSION, DO NOT REMOVE
"aq" = (
/obj/effect/turf_decal/stripes/line{
	dir = 8
	},
/obj/machinery/atmospherics/pipe/smart/manifold4w/scrubbers/hidden/layer2,
/obj/effect/turf_decal/tile/dark_blue{
	dir = 1
	},
/obj/effect/turf_decal/tile/dark_blue,
/turf/open/floor/iron/white,
/area/station/hallway/secondary/entry)
"ar" = (
/obj/structure/flora/bush/fullgrass/style_random,
/obj/structure/flora/bush/ferny/style_random,
/turf/open/floor/grass,
/area/station/hallway/secondary/entry)
"bB" = (
/obj/structure/flora/bush/pale/style_random,
/obj/structure/flora/bush/fullgrass/style_random,
/obj/structure/flora/bush/ferny/style_random,
/obj/machinery/atmospherics/pipe/smart/manifold4w/supply/hidden/layer4,
/obj/machinery/atmospherics/pipe/smart/manifold4w/scrubbers/hidden/layer2,
/obj/effect/landmark/start/hangover,
/turf/open/floor/grass,
/area/station/hallway/secondary/entry)
"bC" = (
/obj/effect/turf_decal/delivery,
/obj/effect/spawner/random/entertainment/arcade{
	dir = 8
	},
/turf/open/floor/iron/dark,
/area/station/hallway/secondary/entry)
"bD" = (
/obj/effect/turf_decal/stripes/line{
	dir = 4
	},
/obj/machinery/atmospherics/pipe/smart/manifold4w/supply/hidden/layer4,
/obj/machinery/atmospherics/pipe/smart/manifold4w/scrubbers/hidden/layer2,
/obj/structure/cable,
/obj/effect/turf_decal/tile/dark_blue{
	dir = 1
	},
/obj/effect/turf_decal/tile/dark_blue,
/turf/open/floor/iron/white,
/area/station/hallway/secondary/entry)
"cL" = (
/obj/machinery/atmospherics/pipe/smart/manifold4w/scrubbers/hidden/layer2,
/obj/effect/turf_decal/tile/dark_blue{
	dir = 1
	},
/obj/effect/turf_decal/tile/dark_blue,
/obj/effect/turf_decal/stripes/corner{
	dir = 8
	},
/obj/structure/disposalpipe/segment{
	dir = 4
	},
/turf/open/floor/iron/white,
/area/station/hallway/secondary/entry)
"ep" = (
/obj/effect/turf_decal/stripes/line{
	dir = 10
	},
/obj/effect/turf_decal/tile/dark_blue{
	dir = 1
	},
/obj/effect/turf_decal/tile/dark_blue,
/obj/machinery/computer/shuttle/arrivals/recall{
	dir = 4
	},
/turf/open/floor/iron/white,
/area/station/hallway/secondary/entry)
"ir" = (
/obj/machinery/atmospherics/pipe/smart/manifold4w/supply/hidden/layer4,
/obj/machinery/atmospherics/pipe/smart/manifold4w/scrubbers/hidden/layer2,
/obj/structure/cable,
/obj/effect/turf_decal/tile/dark_blue{
	dir = 1
	},
/obj/effect/turf_decal/tile/dark_blue,
/turf/open/floor/iron/white,
/area/station/hallway/secondary/entry)
"jI" = (
/obj/effect/turf_decal/delivery,
/obj/effect/spawner/random/vending/colavend,
/turf/open/floor/iron/dark,
/area/station/hallway/secondary/entry)
"kE" = (
/obj/structure/flora/bush/pale/style_random,
/obj/structure/flora/bush/fullgrass/style_random,
/obj/machinery/atmospherics/pipe/smart/manifold4w/supply/hidden/layer4,
/obj/machinery/atmospherics/pipe/smart/manifold4w/scrubbers/hidden/layer2,
/obj/structure/cable,
/turf/open/floor/grass,
/area/station/hallway/secondary/entry)
"lf" = (
/obj/machinery/atmospherics/pipe/smart/manifold4w/scrubbers/hidden/layer2,
/obj/effect/turf_decal/tile/dark_blue{
	dir = 1
	},
/obj/effect/turf_decal/tile/dark_blue,
/obj/structure/disposalpipe/segment{
	dir = 10
	},
/turf/open/floor/iron/white,
/area/station/hallway/secondary/entry)
"mj" = (
/obj/machinery/door/airlock/external{
	name = "Arrival Airlock"
	},
/obj/effect/mapping_helpers/airlock/cyclelink_helper{
	dir = 8
	},
/turf/open/floor/plating,
/area/station/hallway/secondary/entry)
"mo" = (
/obj/effect/turf_decal/delivery,
/obj/effect/spawner/random/entertainment/arcade{
	dir = 4
	},
/turf/open/floor/iron/dark,
/area/station/hallway/secondary/entry)
"mD" = (
/obj/structure/flora/bush/fullgrass/style_random,
/obj/structure/flora/bush/ferny/style_random,
/obj/machinery/atmospherics/pipe/smart/manifold4w/supply/hidden/layer4,
/obj/machinery/atmospherics/pipe/smart/manifold4w/scrubbers/hidden/layer2,
/obj/structure/disposalpipe/segment{
	dir = 5
	},
/turf/open/floor/grass,
/area/station/hallway/secondary/entry)
"mH" = (
/obj/docking_port/stationary{
	dir = 2;
	dwidth = 1;
	height = 13;
	shuttle_id = "arrivals_stationary";
	name = "arrivals";
	roundstart_template = null;
	width = 5
	},
/turf/template_noop,
/area/space)
"ql" = (
/obj/structure/railing{
	dir = 8
	},
/obj/effect/turf_decal/siding/brown{
	dir = 8
	},
/obj/machinery/atmospherics/pipe/smart/manifold4w/supply/hidden/layer4,
/obj/machinery/atmospherics/pipe/smart/manifold4w/scrubbers/hidden/layer2,
/obj/effect/turf_decal/tile/dark_blue,
/obj/effect/turf_decal/stripes/line,
/obj/structure/disposalpipe/segment{
	dir = 4
	},
/turf/open/floor/iron/white,
/area/station/hallway/secondary/entry)
"qQ" = (
/obj/structure/flora/bush/ferny/style_random,
/obj/structure/flora/bush/fullgrass/style_random,
/obj/structure/flora/bush/flowers_br/style_random,
/obj/machinery/atmospherics/pipe/smart/manifold4w/supply/hidden/layer4,
/obj/machinery/atmospherics/pipe/smart/manifold4w/scrubbers/hidden/layer2,
/turf/open/floor/grass,
/area/station/hallway/secondary/entry)
"rQ" = (
/obj/structure/railing/corner{
	dir = 8
	},
/obj/effect/turf_decal/siding/brown/corner{
	dir = 8
	},
/obj/structure/cable,
/obj/machinery/atmospherics/components/unary/vent_pump/on/layer4,
/obj/effect/turf_decal/tile/dark_blue{
	dir = 1
	},
/obj/effect/turf_decal/tile/dark_blue,
/turf/open/floor/iron/white,
/area/station/hallway/secondary/entry)
"sh" = (
/obj/machinery/atmospherics/pipe/smart/manifold4w/scrubbers/hidden/layer2,
/obj/structure/disposalpipe/segment{
	dir = 5
	},
/obj/effect/turf_decal/tile/dark_blue{
	dir = 1
	},
/obj/effect/turf_decal/tile/dark_blue,
/obj/effect/turf_decal/stripes/line{
	dir = 8
	},
/turf/open/floor/iron/white,
/area/station/hallway/secondary/entry)
"sP" = (
/obj/structure/railing{
	dir = 6
	},
/obj/effect/turf_decal/siding/brown{
	dir = 6
	},
/obj/effect/turf_decal/tile/dark_blue{
	dir = 1
	},
/obj/effect/turf_decal/tile/dark_blue,
/turf/open/floor/iron/white,
/area/station/hallway/secondary/entry)
"tX" = (
/obj/effect/turf_decal/stripes/line{
	dir = 4
	},
/obj/machinery/atmospherics/pipe/smart/manifold4w/scrubbers/hidden/layer2,
/obj/effect/turf_decal/tile/dark_blue{
	dir = 1
	},
/obj/effect/turf_decal/tile/dark_blue,
/turf/open/floor/iron/white,
/area/station/hallway/secondary/entry)
"wr" = (
/obj/structure/flora/bush/pale/style_random,
/obj/structure/flora/bush/fullgrass/style_random,
/obj/effect/landmark/start/hangover,
/turf/open/floor/grass,
/area/station/hallway/secondary/entry)
"xs" = (
/turf/open/space/basic,
/area/space)
"yg" = (
/obj/effect/turf_decal/tile/dark_blue{
	dir = 1
	},
/obj/effect/turf_decal/tile/dark_blue,
/turf/open/floor/iron/white,
/area/station/hallway/secondary/entry)
"yk" = (
/obj/effect/turf_decal/delivery,
/obj/structure/table,
/obj/effect/spawner/random/entertainment/cigarette_pack,
/turf/open/floor/iron/dark,
/area/station/hallway/secondary/entry)
"yM" = (
/obj/effect/turf_decal/stripes/line{
	dir = 6
	},
/obj/effect/turf_decal/tile/dark_blue{
	dir = 1
	},
/obj/effect/turf_decal/tile/dark_blue,
/turf/open/floor/iron/white,
/area/station/hallway/secondary/entry)
"Bo" = (
/obj/structure/flora/bush/fullgrass/style_random,
/obj/structure/flora/bush/pale/style_random,
/obj/structure/flora/bush/flowers_br/style_random,
/obj/machinery/atmospherics/pipe/smart/manifold4w/scrubbers/hidden/layer2,
/obj/machinery/atmospherics/pipe/smart/manifold4w/supply/hidden/layer4,
/obj/structure/cable,
/turf/open/floor/grass,
/area/station/hallway/secondary/entry)
"Bs" = (
/obj/machinery/atmospherics/pipe/smart/manifold4w/supply/hidden/layer4,
/obj/machinery/atmospherics/pipe/smart/manifold4w/scrubbers/hidden/layer2,
/obj/structure/cable,
/obj/effect/turf_decal/tile/dark_blue{
	dir = 1
	},
/obj/effect/turf_decal/tile/dark_blue,
/obj/effect/turf_decal/stripes/line{
	dir = 4
	},
/turf/open/floor/iron/white,
/area/station/hallway/secondary/entry)
"Em" = (
/obj/effect/turf_decal/delivery,
/obj/structure/table,
/obj/effect/spawner/random/food_or_drink,
/turf/open/floor/iron/dark,
/area/station/hallway/secondary/entry)
"FZ" = (
/obj/effect/turf_decal/delivery,
/obj/effect/spawner/random/vending/snackvend,
/turf/open/floor/iron/dark,
/area/station/hallway/secondary/entry)
"Ge" = (
/obj/machinery/atmospherics/pipe/smart/manifold4w/scrubbers/hidden/layer2,
/obj/effect/turf_decal/tile/dark_blue{
	dir = 1
	},
/obj/effect/turf_decal/tile/dark_blue,
/obj/effect/turf_decal/stripes/corner{
	dir = 8
	},
/obj/structure/disposalpipe/segment,
/turf/open/floor/iron/white,
/area/station/hallway/secondary/entry)
"GT" = (
/turf/template_noop,
/area/template_noop)
"Hd" = (
/obj/machinery/door/airlock/external{
	name = "Arrival Airlock";
	space_dir = 8
	},
/obj/effect/mapping_helpers/airlock/cyclelink_helper{
	dir = 4
	},
/turf/open/floor/plating,
/area/station/hallway/secondary/entry)
"HL" = (
/obj/machinery/door/airlock/external{
	name = "Arrival Airlock"
	},
/obj/effect/mapping_helpers/airlock/cyclelink_helper{
	dir = 4
	},
/turf/open/floor/plating,
/area/station/hallway/secondary/entry)
"It" = (
/obj/structure/flora/bush/ferny/style_random,
/obj/structure/flora/bush/fullgrass/style_random,
/obj/machinery/atmospherics/pipe/smart/manifold4w/scrubbers/hidden/layer2,
/obj/machinery/atmospherics/pipe/smart/manifold4w/supply/hidden/layer4,
/obj/structure/cable,
/obj/machinery/light/floor,
/obj/machinery/camera/autoname/directional/south,
/turf/open/floor/grass,
/area/station/hallway/secondary/entry)
"IG" = (
/obj/structure/flora/bush/ferny/style_random,
/obj/structure/flora/bush/fullgrass/style_random,
/obj/structure/flora/bush/ferny/style_random,
/obj/structure/cable,
/turf/open/floor/grass,
/area/station/hallway/secondary/entry)
"Jn" = (
/turf/closed/wall/r_wall,
/area/station/hallway/secondary/entry)
"LF" = (
/obj/structure/railing{
	dir = 4
	},
/obj/effect/turf_decal/siding/brown{
	dir = 4
	},
/obj/machinery/atmospherics/pipe/smart/manifold4w/supply/hidden/layer4,
/obj/machinery/atmospherics/pipe/smart/manifold4w/scrubbers/hidden/layer2,
/obj/structure/cable,
/obj/effect/turf_decal/tile/dark_blue{
	dir = 1
	},
/obj/effect/turf_decal/stripes/line,
/turf/open/floor/iron/white,
/area/station/hallway/secondary/entry)
"LP" = (
/obj/structure/railing/corner,
/obj/effect/turf_decal/siding/brown/corner,
/obj/machinery/atmospherics/components/unary/vent_pump/on/layer4,
/obj/effect/turf_decal/tile/dark_blue{
	dir = 1
	},
/obj/effect/turf_decal/tile/dark_blue,
/turf/open/floor/iron/white,
/area/station/hallway/secondary/entry)
"LU" = (
/obj/structure/flora/bush/pale/style_random,
/obj/structure/flora/bush/fullgrass/style_random,
/obj/machinery/atmospherics/pipe/smart/manifold4w/supply/hidden/layer4,
/obj/machinery/atmospherics/pipe/smart/manifold4w/scrubbers/hidden/layer2,
/turf/open/floor/grass,
/area/station/hallway/secondary/entry)
"Oq" = (
/obj/structure/flora/bush/ferny/style_random,
/obj/structure/flora/bush/fullgrass/style_random,
/obj/structure/flora/bush/pale/style_random,
/obj/machinery/atmospherics/pipe/smart/manifold4w/supply/hidden/layer4,
/obj/machinery/atmospherics/pipe/smart/manifold4w/scrubbers/hidden/layer2,
/obj/structure/cable,
/turf/open/floor/grass,
/area/station/hallway/secondary/entry)
"OJ" = (
/turf/open/floor/plating,
/area/station/hallway/secondary/entry)
"PQ" = (
/obj/structure/flora/bush/fullgrass/style_random,
/obj/structure/flora/bush/flowers_br/style_random,
/obj/machinery/atmospherics/pipe/smart/manifold4w/supply/hidden/layer4,
/obj/machinery/atmospherics/pipe/smart/manifold4w/scrubbers/hidden/layer2,
/obj/structure/cable,
/turf/open/floor/grass,
/area/station/hallway/secondary/entry)
"QN" = (
/obj/effect/spawner/structure/window/reinforced,
/turf/open/floor/plating,
/area/station/hallway/secondary/entry)
"Ti" = (
/obj/structure/flora/bush/flowers_br/style_random,
/obj/structure/flora/bush/fullgrass/style_random,
/turf/open/floor/grass,
/area/station/hallway/secondary/entry)
"Tt" = (
/obj/structure/railing{
	dir = 10
	},
/obj/effect/turf_decal/siding/brown{
	dir = 10
	},
/obj/structure/cable,
/obj/structure/disposalpipe/segment,
/obj/effect/turf_decal/tile/dark_blue{
	dir = 1
	},
/obj/effect/turf_decal/tile/dark_blue,
/turf/open/floor/iron/white,
/area/station/hallway/secondary/entry)
"TG" = (
/obj/structure/flora/bush/flowers_br/style_random,
/obj/structure/flora/bush/pale/style_random,
/obj/structure/flora/bush/fullgrass/style_random,
/obj/machinery/atmospherics/pipe/smart/manifold4w/supply/hidden/layer4,
/obj/machinery/atmospherics/pipe/smart/manifold4w/scrubbers/hidden/layer2,
/obj/structure/cable,
/turf/open/floor/grass,
/area/station/hallway/secondary/entry)
"TJ" = (
/obj/effect/turf_decal/delivery,
/obj/machinery/vending/coffee,
/turf/open/floor/iron/dark,
/area/station/hallway/secondary/entry)
"Uy" = (
/obj/structure/flora/bush/flowers_br/style_random,
/obj/structure/flora/bush/fullgrass/style_random,
/obj/structure/cable,
/turf/open/floor/grass,
/area/station/hallway/secondary/entry)
"Vf" = (
/obj/structure/cable,
/obj/effect/turf_decal/tile/dark_blue{
	dir = 1
	},
/obj/effect/turf_decal/tile/dark_blue,
/turf/open/floor/iron/white,
/area/station/hallway/secondary/entry)
"Wm" = (
/obj/machinery/atmospherics/pipe/smart/manifold4w/supply/hidden/layer4,
/obj/machinery/atmospherics/pipe/smart/manifold4w/scrubbers/hidden/layer2,
/obj/structure/cable,
/obj/effect/turf_decal/tile/dark_blue{
	dir = 1
	},
/obj/effect/turf_decal/tile/dark_blue,
/obj/effect/turf_decal/stripes/corner,
/turf/open/floor/iron/white,
/area/station/hallway/secondary/entry)
"YZ" = (
/obj/structure/flora/bush/fullgrass/style_random,
/obj/structure/flora/bush/pale/style_random,
/obj/structure/cable,
/turf/open/floor/grass,
/area/station/hallway/secondary/entry)
"Zp" = (
/obj/machinery/door/airlock/external{
	name = "Arrival Airlock";
	space_dir = 4
	},
/obj/effect/mapping_helpers/airlock/cyclelink_helper{
	dir = 8
	},
/turf/open/floor/plating,
/area/station/hallway/secondary/entry)

(1,1,1) = {"
yg
ir
Wm
Bs
bD
bD
bD
tX
tX
tX
"}
(2,1,1) = {"
yg
Wm
yM
FZ
yk
TJ
QN
HL
QN
bC
"}
(3,1,1) = {"
LP
LF
Jn
Jn
QN
Jn
QN
OJ
QN
Jn
"}
(4,1,1) = {"
sP
TG
QN
GT
GT
GT
QN
Zp
QN
GT
"}
(5,1,1) = {"
ar
kE
QN
GT
GT
GT
GT
GT
GT
GT
"}
(6,1,1) = {"
Ti
Oq
QN
GT
GT
GT
GT
GT
GT
GT
"}
(7,1,1) = {"
wr
PQ
QN
GT
GT
GT
GT
GT
GT
GT
"}
(8,1,1) = {"
Bo
It
Jn
xs
GT
GT
GT
GT
GT
GT
"}
(9,1,1) = {"
Uy
bB
QN
GT
GT
GT
GT
GT
GT
GT
"}
(10,1,1) = {"
IG
LU
QN
GT
GT
mH
GT
GT
GT
GT
"}
(11,1,1) = {"
YZ
qQ
QN
GT
GT
GT
GT
GT
GT
GT
"}
(12,1,1) = {"
Tt
mD
QN
GT
GT
GT
QN
Hd
QN
GT
"}
(13,1,1) = {"
rQ
ql
Jn
Jn
QN
Jn
QN
OJ
QN
Jn
"}
(14,1,1) = {"
Vf
cL
ep
jI
Em
TJ
QN
mj
QN
mo
"}
(15,1,1) = {"
Vf
lf
Ge
sh
aq
aq
aq
aq
aq
aq
"}
