//MAP CONVERTED BY dmm2tgm.py THIS HEADER COMMENT PREVENTS RECONVERSION, DO NOT REMOVE
"a" = (
/turf/template_noop,
/area/template_noop)
"b" = (
/turf/closed/wall/r_wall,
/area/station/ai_monitored/security/armory)
"p" = (
/obj/structure/rack,
/obj/machinery/airalarm/directional/west,
/obj/effect/spawner/armory_spawn/shotguns,
/turf/open/floor/iron/dark/smooth_large,
/area/station/ai_monitored/security/armory)
"w" = (
/obj/structure/rack,
/obj/item/gun/ballistic/automatic/battle_rifle{
	pixel_y = 3
	},
/obj/item/gun/energy/temperature/security,
/obj/item/gun/energy/ionrifle,
/obj/item/clothing/suit/hooded/ablative,
/turf/open/floor/iron/dark/smooth_large,
/area/station/ai_monitored/security/armory)
"x" = (
/obj/machinery/requests_console/directional/north{
	department = "Security";
	name = "Security Requests Console";
	pixel_x = -30;
	pixel_y = 0
	},
/obj/effect/mapping_helpers/requests_console/supplies,
/obj/effect/mapping_helpers/requests_console/assistance,
/obj/structure/rack/gunrack,
/obj/effect/spawner/armory_spawn/mod_lasers_small,
/turf/open/floor/iron/dark/smooth_large,
/area/station/ai_monitored/security/armory)
"A" = (
/obj/structure/reagent_dispensers/wall/peppertank/directional/west,
/obj/machinery/light/directional/west,
/obj/structure/rack,
/obj/effect/spawner/random/armory/riot_helmet{
	pixel_x = -1;
	pixel_y = 1
	},
/obj/effect/spawner/random/armory/bulletproof_helmet{
	pixel_x = 8;
	pixel_y = 0
	},
/obj/structure/cable,
/obj/machinery/power/apc/auto_name/directional/south,
/turf/open/floor/iron/dark/smooth_large,
/area/station/ai_monitored/security/armory)
"F" = (
/obj/machinery/newscaster/directional/west,
/obj/machinery/camera/motion{
	c_tag = "Armory - Internal";
	dir = 8
	},
/obj/structure/rack/gunrack,
/obj/effect/spawner/armory_spawn/mod_lasers_big,
/turf/open/floor/iron/dark/smooth_large,
/area/station/ai_monitored/security/armory)
"L" = (
/obj/structure/table,
/obj/item/radio/intercom/directional/west,
/obj/machinery/light/small/directional/west,
/obj/effect/spawner/armory_spawn/smg,
/turf/open/floor/iron/dark/smooth_large,
/area/station/ai_monitored/security/armory)

(1,1,1) = {"
b
b
x
F
L
a
p
a
"}
(2,1,1) = {"
b
w
a
a
a
a
a
A
"}
