//MAP CONVERTED BY dmm2tgm.py THIS HEADER COMMENT PREVENTS RECONVERSION, DO NOT REMOVE
"aV" = (
/obj/structure/flora/bush/ferny/style_random,
/obj/structure/flora/bush/fullgrass/style_random,
/obj/structure/flora/bush/pale/style_random,
/obj/machinery/atmospherics/pipe/smart/manifold4w/supply/hidden/layer4,
/obj/machinery/atmospherics/pipe/smart/manifold4w/scrubbers/hidden/layer2,
/obj/structure/cable,
/turf/open/floor/grass,
/area/station/hallway/secondary/entry)
"cN" = (
/obj/effect/turf_decal/delivery,
/obj/machinery/computer/shuttle/arrivals/recall{
	dir = 8
	},
/turf/open/floor/iron/dark,
/area/station/hallway/secondary/entry)
"el" = (
/obj/docking_port/stationary{
	dir = 2;
	dwidth = 1;
	height = 13;
	shuttle_id = "arrivals_stationary";
	name = "arrivals";
	roundstart_template = null;
	width = 5
	},
/turf/open/space/basic,
/area/space)
"eR" = (
/obj/structure/flora/bush/ferny/style_random,
/obj/structure/flora/bush/fullgrass/style_random,
/obj/structure/flora/bush/flowers_br/style_random,
/obj/machinery/atmospherics/pipe/smart/manifold4w/supply/hidden/layer4,
/obj/machinery/atmospherics/pipe/smart/manifold4w/scrubbers/hidden/layer2,
/turf/open/floor/grass,
/area/station/hallway/secondary/entry)
"fa" = (
/obj/structure/flora/bush/fullgrass/style_random,
/obj/structure/flora/bush/flowers_br/style_random,
/obj/machinery/atmospherics/pipe/smart/manifold4w/supply/hidden/layer4,
/obj/machinery/atmospherics/pipe/smart/manifold4w/scrubbers/hidden/layer2,
/obj/structure/cable,
/turf/open/floor/grass,
/area/station/hallway/secondary/entry)
"fb" = (
/obj/effect/turf_decal/delivery,
/obj/effect/spawner/random/entertainment/arcade{
	dir = 4
	},
/turf/open/floor/iron/dark,
/area/station/hallway/secondary/entry)
"fj" = (
/obj/structure/railing{
	dir = 4
	},
/obj/effect/turf_decal/siding/brown{
	dir = 4
	},
/obj/machinery/atmospherics/pipe/smart/manifold4w/supply/hidden/layer4,
/obj/machinery/atmospherics/pipe/smart/manifold4w/scrubbers/hidden/layer2,
/obj/structure/cable,
/obj/effect/turf_decal/tile/dark_blue{
	dir = 1
	},
/obj/effect/turf_decal/stripes/corner{
	dir = 8
	},
/turf/open/floor/iron/white,
/area/station/hallway/secondary/entry)
"gL" = (
/obj/machinery/atmospherics/pipe/smart/manifold4w/supply/hidden/layer4,
/obj/machinery/atmospherics/pipe/smart/manifold4w/scrubbers/hidden/layer2,
/obj/structure/cable,
/obj/effect/turf_decal/tile/dark_blue{
	dir = 1
	},
/obj/effect/turf_decal/tile/dark_blue,
/obj/effect/turf_decal/stripes/line{
	dir = 4
	},
/turf/open/floor/iron/white,
/area/station/hallway/secondary/entry)
"hX" = (
/turf/open/space/basic,
/area/space)
"ky" = (
/obj/effect/turf_decal/delivery,
/obj/effect/spawner/random/vending/snackvend,
/turf/open/floor/iron/dark,
/area/station/hallway/secondary/entry)
"kE" = (
/obj/machinery/atmospherics/pipe/smart/manifold4w/supply/hidden/layer4,
/obj/machinery/atmospherics/pipe/smart/manifold4w/scrubbers/hidden/layer2,
/obj/structure/cable,
/obj/effect/turf_decal/tile/dark_blue{
	dir = 1
	},
/obj/effect/turf_decal/tile/dark_blue,
/obj/effect/turf_decal/stripes/line,
/turf/open/floor/iron/white,
/area/station/hallway/secondary/entry)
"lE" = (
/obj/effect/turf_decal/stripes/line{
	dir = 8
	},
/obj/machinery/atmospherics/pipe/smart/manifold4w/scrubbers/hidden/layer2,
/obj/effect/turf_decal/tile/dark_blue{
	dir = 1
	},
/obj/effect/turf_decal/tile/dark_blue,
/turf/open/floor/iron/white,
/area/station/hallway/secondary/entry)
"mJ" = (
/obj/structure/railing/corner{
	dir = 8
	},
/obj/effect/turf_decal/siding/brown/corner{
	dir = 8
	},
/obj/structure/cable,
/obj/machinery/atmospherics/components/unary/vent_pump/on/layer4,
/obj/effect/turf_decal/tile/dark_blue{
	dir = 1
	},
/obj/effect/turf_decal/tile/dark_blue,
/turf/open/floor/iron/white,
/area/station/hallway/secondary/entry)
"nm" = (
/obj/structure/flora/bush/ferny/style_random,
/obj/structure/flora/bush/fullgrass/style_random,
/obj/machinery/atmospherics/pipe/smart/manifold4w/scrubbers/hidden/layer2,
/obj/machinery/atmospherics/pipe/smart/manifold4w/supply/hidden/layer4,
/obj/structure/cable,
/obj/machinery/light/floor,
/obj/machinery/camera/autoname/directional/south,
/turf/open/floor/grass,
/area/station/hallway/secondary/entry)
"of" = (
/obj/effect/turf_decal/tile/dark_blue{
	dir = 1
	},
/obj/effect/turf_decal/tile/dark_blue,
/turf/open/floor/iron/white,
/area/station/hallway/secondary/entry)
"ov" = (
/obj/effect/turf_decal/stripes/line{
	dir = 4
	},
/obj/machinery/atmospherics/pipe/smart/manifold4w/scrubbers/hidden/layer2,
/obj/effect/turf_decal/tile/dark_blue{
	dir = 1
	},
/obj/effect/turf_decal/tile/dark_blue,
/turf/open/floor/iron/white,
/area/station/hallway/secondary/entry)
"oN" = (
/obj/structure/flora/bush/pale/style_random,
/obj/structure/flora/bush/fullgrass/style_random,
/obj/effect/landmark/start/hangover,
/turf/open/floor/grass,
/area/station/hallway/secondary/entry)
"qk" = (
/obj/structure/flora/bush/pale/style_random,
/obj/structure/flora/bush/fullgrass/style_random,
/obj/structure/flora/bush/ferny/style_random,
/obj/machinery/atmospherics/pipe/smart/manifold4w/supply/hidden/layer4,
/obj/machinery/atmospherics/pipe/smart/manifold4w/scrubbers/hidden/layer2,
/obj/effect/landmark/start/hangover,
/turf/open/floor/grass,
/area/station/hallway/secondary/entry)
"qR" = (
/obj/effect/turf_decal/tile/dark_blue{
	dir = 1
	},
/obj/effect/turf_decal/delivery,
/obj/machinery/vending/coffee,
/turf/open/floor/iron/dark,
/area/station/hallway/secondary/entry)
"sj" = (
/obj/structure/flora/bush/pale/style_random,
/obj/structure/flora/bush/fullgrass/style_random,
/obj/machinery/atmospherics/pipe/smart/manifold4w/supply/hidden/layer4,
/obj/machinery/atmospherics/pipe/smart/manifold4w/scrubbers/hidden/layer2,
/turf/open/floor/grass,
/area/station/hallway/secondary/entry)
"tb" = (
/obj/structure/flora/bush/flowers_br/style_random,
/obj/structure/flora/bush/fullgrass/style_random,
/obj/structure/cable,
/turf/open/floor/grass,
/area/station/hallway/secondary/entry)
"tT" = (
/obj/machinery/atmospherics/pipe/smart/manifold4w/scrubbers/hidden/layer2,
/obj/effect/turf_decal/tile/dark_blue{
	dir = 1
	},
/obj/effect/turf_decal/tile/dark_blue,
/obj/structure/disposalpipe/segment{
	dir = 10
	},
/obj/effect/turf_decal/stripes/corner{
	dir = 8
	},
/turf/open/floor/iron/white,
/area/station/hallway/secondary/entry)
"us" = (
/obj/machinery/atmospherics/pipe/smart/manifold4w/scrubbers/hidden/layer2,
/obj/effect/turf_decal/tile/dark_blue{
	dir = 1
	},
/obj/effect/turf_decal/tile/dark_blue,
/obj/structure/disposalpipe/segment{
	dir = 4
	},
/obj/effect/turf_decal/stripes/line,
/turf/open/floor/iron/white,
/area/station/hallway/secondary/entry)
"vh" = (
/obj/structure/railing{
	dir = 10
	},
/obj/effect/turf_decal/siding/brown{
	dir = 10
	},
/obj/structure/cable,
/obj/structure/disposalpipe/segment,
/obj/effect/turf_decal/tile/dark_blue{
	dir = 1
	},
/obj/effect/turf_decal/tile/dark_blue,
/turf/open/floor/iron/white,
/area/station/hallway/secondary/entry)
"vF" = (
/turf/closed/wall/r_wall,
/area/station/hallway/secondary/entry)
"we" = (
/obj/structure/railing{
	dir = 6
	},
/obj/effect/turf_decal/siding/brown{
	dir = 6
	},
/obj/effect/turf_decal/tile/dark_blue{
	dir = 1
	},
/obj/effect/turf_decal/tile/dark_blue,
/turf/open/floor/iron/white,
/area/station/hallway/secondary/entry)
"xh" = (
/obj/structure/flora/bush/fullgrass/style_random,
/obj/structure/flora/bush/pale/style_random,
/obj/structure/cable,
/turf/open/floor/grass,
/area/station/hallway/secondary/entry)
"xN" = (
/obj/effect/turf_decal/delivery,
/obj/effect/spawner/random/vending/colavend,
/turf/open/floor/iron/dark,
/area/station/hallway/secondary/entry)
"yr" = (
/obj/structure/railing{
	dir = 8
	},
/obj/effect/turf_decal/siding/brown{
	dir = 8
	},
/obj/machinery/atmospherics/pipe/smart/manifold4w/supply/hidden/layer4,
/obj/machinery/atmospherics/pipe/smart/manifold4w/scrubbers/hidden/layer2,
/obj/effect/turf_decal/tile/dark_blue,
/obj/structure/disposalpipe/segment{
	dir = 4
	},
/obj/effect/turf_decal/stripes/corner,
/turf/open/floor/iron/white,
/area/station/hallway/secondary/entry)
"ys" = (
/turf/open/floor/plating,
/area/station/hallway/secondary/entry)
"zb" = (
/obj/effect/turf_decal/delivery,
/obj/structure/table,
/obj/effect/spawner/random/entertainment/cigarette_pack,
/turf/open/floor/iron/dark,
/area/station/hallway/secondary/entry)
"Ab" = (
/obj/effect/turf_decal/delivery,
/obj/effect/spawner/random/entertainment/arcade{
	dir = 8
	},
/turf/open/floor/iron/dark,
/area/station/hallway/secondary/entry)
"Af" = (
/obj/structure/flora/bush/fullgrass/style_random,
/obj/structure/flora/bush/ferny/style_random,
/turf/open/floor/grass,
/area/station/hallway/secondary/entry)
"Cl" = (
/obj/structure/flora/bush/ferny/style_random,
/obj/structure/flora/bush/fullgrass/style_random,
/obj/structure/flora/bush/ferny/style_random,
/obj/structure/cable,
/turf/open/floor/grass,
/area/station/hallway/secondary/entry)
"CT" = (
/obj/structure/flora/bush/flowers_br/style_random,
/obj/structure/flora/bush/pale/style_random,
/obj/structure/flora/bush/fullgrass/style_random,
/obj/machinery/atmospherics/pipe/smart/manifold4w/supply/hidden/layer4,
/obj/machinery/atmospherics/pipe/smart/manifold4w/scrubbers/hidden/layer2,
/obj/structure/cable,
/turf/open/floor/grass,
/area/station/hallway/secondary/entry)
"Eb" = (
/obj/effect/turf_decal/delivery,
/obj/structure/table,
/obj/effect/spawner/random/food_or_drink,
/turf/open/floor/iron/dark,
/area/station/hallway/secondary/entry)
"Ey" = (
/obj/machinery/door/airlock/external{
	name = "Arrival Airlock";
	space_dir = 4
	},
/obj/effect/mapping_helpers/airlock/cyclelink_helper{
	dir = 8
	},
/turf/open/floor/plating,
/area/station/hallway/secondary/entry)
"ED" = (
/obj/effect/turf_decal/stripes/line{
	dir = 4
	},
/obj/machinery/atmospherics/pipe/smart/manifold4w/supply/hidden/layer4,
/obj/machinery/atmospherics/pipe/smart/manifold4w/scrubbers/hidden/layer2,
/obj/structure/cable,
/obj/effect/turf_decal/tile/dark_blue{
	dir = 1
	},
/obj/effect/turf_decal/tile/dark_blue,
/turf/open/floor/iron/white,
/area/station/hallway/secondary/entry)
"Gh" = (
/obj/structure/flora/bush/fullgrass/style_random,
/obj/structure/flora/bush/pale/style_random,
/obj/structure/flora/bush/flowers_br/style_random,
/obj/machinery/atmospherics/pipe/smart/manifold4w/scrubbers/hidden/layer2,
/obj/machinery/atmospherics/pipe/smart/manifold4w/supply/hidden/layer4,
/obj/structure/cable,
/turf/open/floor/grass,
/area/station/hallway/secondary/entry)
"GF" = (
/obj/machinery/atmospherics/pipe/smart/manifold4w/scrubbers/hidden/layer2,
/obj/effect/turf_decal/tile/dark_blue{
	dir = 1
	},
/obj/effect/turf_decal/tile/dark_blue,
/obj/effect/turf_decal/stripes/corner{
	dir = 8
	},
/obj/structure/disposalpipe/segment,
/obj/effect/turf_decal/stripes/line{
	dir = 8
	},
/turf/open/floor/iron/white,
/area/station/hallway/secondary/entry)
"IX" = (
/obj/machinery/atmospherics/pipe/smart/manifold4w/supply/hidden/layer4,
/obj/machinery/atmospherics/pipe/smart/manifold4w/scrubbers/hidden/layer2,
/obj/structure/cable,
/obj/effect/turf_decal/tile/dark_blue{
	dir = 1
	},
/obj/effect/turf_decal/tile/dark_blue,
/obj/effect/turf_decal/stripes/corner,
/turf/open/floor/iron/white,
/area/station/hallway/secondary/entry)
"NZ" = (
/obj/machinery/status_display/shuttle/directional/west,
/obj/effect/turf_decal/delivery,
/obj/machinery/vending/coffee,
/turf/open/floor/iron/dark,
/area/station/hallway/secondary/entry)
"OU" = (
/obj/structure/flora/bush/pale/style_random,
/obj/structure/flora/bush/fullgrass/style_random,
/obj/machinery/atmospherics/pipe/smart/manifold4w/supply/hidden/layer4,
/obj/machinery/atmospherics/pipe/smart/manifold4w/scrubbers/hidden/layer2,
/obj/structure/cable,
/turf/open/floor/grass,
/area/station/hallway/secondary/entry)
"Pq" = (
/obj/structure/flora/bush/fullgrass/style_random,
/obj/structure/flora/bush/ferny/style_random,
/obj/machinery/atmospherics/pipe/smart/manifold4w/supply/hidden/layer4,
/obj/machinery/atmospherics/pipe/smart/manifold4w/scrubbers/hidden/layer2,
/obj/structure/disposalpipe/segment{
	dir = 5
	},
/turf/open/floor/grass,
/area/station/hallway/secondary/entry)
"PD" = (
/obj/machinery/door/airlock/external{
	name = "Arrival Airlock";
	space_dir = 8
	},
/obj/effect/mapping_helpers/airlock/cyclelink_helper{
	dir = 4
	},
/turf/open/floor/plating,
/area/station/hallway/secondary/entry)
"Qr" = (
/obj/structure/railing/corner,
/obj/effect/turf_decal/siding/brown/corner,
/obj/machinery/atmospherics/components/unary/vent_pump/on/layer4,
/obj/effect/turf_decal/tile/dark_blue{
	dir = 1
	},
/obj/effect/turf_decal/tile/dark_blue,
/turf/open/floor/iron/white,
/area/station/hallway/secondary/entry)
"RV" = (
/obj/structure/cable,
/obj/effect/turf_decal/tile/dark_blue{
	dir = 1
	},
/obj/effect/turf_decal/tile/dark_blue,
/turf/open/floor/iron/white,
/area/station/hallway/secondary/entry)
"Sk" = (
/obj/machinery/door/airlock/external{
	name = "Arrival Airlock"
	},
/obj/effect/mapping_helpers/airlock/cyclelink_helper{
	dir = 8
	},
/turf/open/floor/plating,
/area/station/hallway/secondary/entry)
"SX" = (
/obj/effect/spawner/structure/window/reinforced,
/turf/open/floor/plating,
/area/station/hallway/secondary/entry)
"Th" = (
/obj/machinery/atmospherics/pipe/smart/manifold4w/scrubbers/hidden/layer2,
/obj/structure/disposalpipe/segment{
	dir = 5
	},
/obj/effect/turf_decal/tile/dark_blue{
	dir = 1
	},
/obj/effect/turf_decal/tile/dark_blue,
/obj/effect/turf_decal/stripes/line{
	dir = 8
	},
/turf/open/floor/iron/white,
/area/station/hallway/secondary/entry)
"Tw" = (
/obj/machinery/door/airlock/external{
	name = "Arrival Airlock"
	},
/obj/effect/mapping_helpers/airlock/cyclelink_helper{
	dir = 4
	},
/turf/open/floor/plating,
/area/station/hallway/secondary/entry)
"TP" = (
/obj/structure/flora/bush/flowers_br/style_random,
/obj/structure/flora/bush/fullgrass/style_random,
/turf/open/floor/grass,
/area/station/hallway/secondary/entry)
"Vn" = (
/obj/effect/turf_decal/delivery,
/obj/machinery/computer/shuttle/arrivals/recall{
	dir = 4
	},
/turf/open/floor/iron/dark,
/area/station/hallway/secondary/entry)

(1,1,1) = {"
of
IX
gL
gL
ED
ED
ED
ov
ov
ov
"}
(2,1,1) = {"
of
kE
qR
ky
zb
cN
SX
Tw
SX
Ab
"}
(3,1,1) = {"
Qr
fj
vF
vF
SX
vF
SX
ys
SX
vF
"}
(4,1,1) = {"
we
CT
SX
hX
hX
hX
SX
Ey
SX
hX
"}
(5,1,1) = {"
Af
OU
SX
hX
hX
hX
hX
hX
hX
hX
"}
(6,1,1) = {"
TP
aV
SX
hX
hX
hX
hX
hX
hX
hX
"}
(7,1,1) = {"
oN
fa
SX
hX
hX
hX
hX
hX
hX
hX
"}
(8,1,1) = {"
Gh
nm
vF
hX
hX
hX
hX
hX
hX
hX
"}
(9,1,1) = {"
tb
qk
SX
hX
hX
hX
hX
hX
hX
hX
"}
(10,1,1) = {"
Cl
sj
SX
hX
hX
el
hX
hX
hX
hX
"}
(11,1,1) = {"
xh
eR
SX
hX
hX
hX
hX
hX
hX
hX
"}
(12,1,1) = {"
vh
Pq
SX
hX
hX
hX
SX
PD
SX
hX
"}
(13,1,1) = {"
mJ
yr
vF
vF
SX
vF
SX
ys
SX
vF
"}
(14,1,1) = {"
RV
us
NZ
xN
Eb
Vn
SX
Sk
SX
fb
"}
(15,1,1) = {"
RV
tT
GF
Th
lE
lE
lE
lE
lE
lE
"}
