//MAP CONVERTED BY dmm2tgm.py THIS HEADER COMMENT PREVENTS RECONVERSION, DO NOT REMOVE
"a" = (
/turf/template_noop,
/area/template_noop)
"g" = (
/obj/effect/decal/cleanable/dirt,
/obj/effect/turf_decal/trimline/green/filled/line{
	dir = 1
	},
/obj/machinery/vending/hydronutrients,
/turf/open/floor/iron/dark,
/area/station/service/hydroponics/garden/abandoned)
"o" = (
/obj/machinery/hydroponics/constructable,
/turf/open/misc/sandy_dirt,
/area/station/service/hydroponics/garden/abandoned)
"S" = (
/obj/effect/decal/cleanable/dirt,
/obj/effect/turf_decal/trimline/green/filled/line{
	dir = 1
	},
/obj/machinery/vending/hydroseeds,
/turf/open/floor/iron/dark,
/area/station/service/hydroponics/garden/abandoned)

(1,1,1) = {"
a
a
a
a
a
a
"}
(2,1,1) = {"
a
a
a
a
a
o
"}
(3,1,1) = {"
a
S
a
a
a
o
"}
(4,1,1) = {"
a
g
a
a
a
o
"}
(5,1,1) = {"
a
a
a
a
a
a
"}
(6,1,1) = {"
a
a
a
a
a
a
"}
(7,1,1) = {"
a
a
a
a
a
a
"}
