//MAP CONVERTED BY dmm2tgm.py THIS HEADER COMMENT PREVENTS RECONVERSION, DO NOT REMOVE
"a" = (
/turf/template_noop,
/area/template_noop)
"r" = (
/obj/effect/turf_decal/stripes/red/box,
/obj/structure/sign/delam_procedure/directional/east{
	pixel_y = -28
	},
/turf/open/floor/engine,
/area/station/engineering/supermatter/room)
"w" = (
/obj/machinery/atmospherics/components/unary/delam_scram/directional/west,
/turf/template_noop,
/area/station/engineering/supermatter)
"R" = (
/turf/closed/wall/r_wall,
/area/station/engineering/supermatter)
"T" = (
/obj/machinery/button/delam_scram,
/turf/closed/wall/r_wall,
/area/station/engineering/supermatter)

(1,1,1) = {"
a
r
a
"}
(2,1,1) = {"
a
T
R
"}
(3,1,1) = {"
a
a
w
"}
