//MAP CONVERTED BY dmm2tgm.py THIS HEADER COMMENT PREVENTS RECONVERSION, DO NOT REMOVE
"aV" = (
/obj/structure/flora/bush/pale/style_random,
/obj/structure/flora/bush/fullgrass/style_random,
/obj/structure/flora/bush/ferny/style_random,
/obj/machinery/light/floor,
/turf/open/floor/grass,
/area/station/hallway/secondary/entry)
"cN" = (
/obj/machinery/computer/shuttle/arrivals/recall{
	dir = 8
	},
/obj/effect/turf_decal/bot_white,
/turf/open/floor/iron/dark,
/area/station/hallway/secondary/entry)
"dT" = (
/obj/effect/turf_decal/trimline/blue/filled/corner{
	dir = 8
	},
/obj/machinery/atmospherics/pipe/smart/manifold4w/scrubbers/hidden/layer2,
/obj/machinery/atmospherics/pipe/smart/manifold4w/supply/hidden/layer4,
/obj/structure/cable,
/turf/open/floor/iron/white/side{
	dir = 4
	},
/area/station/hallway/secondary/entry)
"el" = (
/obj/docking_port/stationary{
	dir = 2;
	dwidth = 1;
	height = 13;
	shuttle_id = "arrivals_stationary";
	name = "arrivals";
	roundstart_template = null;
	width = 5
	},
/turf/open/space/basic,
/area/space)
"fa" = (
/obj/structure/flora/bush/fullgrass/style_random,
/turf/open/floor/grass,
/area/station/hallway/secondary/entry)
"fb" = (
/obj/machinery/vending/cigarette,
/obj/effect/turf_decal/bot_white,
/obj/effect/turf_decal/siding/dark_blue{
	dir = 4
	},
/turf/open/floor/iron/dark,
/area/station/hallway/secondary/entry)
"fj" = (
/obj/structure/railing{
	dir = 4
	},
/obj/effect/turf_decal/siding/brown{
	dir = 4
	},
/obj/item/kirbyplants/random,
/obj/structure/sign/warning/vacuum/external/directional/south,
/turf/open/floor/iron/white/corner{
	dir = 1
	},
/area/station/hallway/secondary/entry)
"gL" = (
/obj/machinery/atmospherics/pipe/smart/manifold4w/supply/hidden/layer4,
/obj/machinery/atmospherics/pipe/smart/manifold4w/scrubbers/hidden/layer2,
/obj/structure/cable,
/obj/effect/turf_decal/tile/dark_blue{
	dir = 1
	},
/obj/effect/turf_decal/tile/dark_blue,
/obj/effect/turf_decal/stripes/line{
	dir = 4
	},
/turf/open/floor/iron/white,
/area/station/hallway/secondary/entry)
"hX" = (
/turf/open/space/basic,
/area/space)
"ky" = (
/obj/effect/spawner/random/vending/snackvend,
/obj/effect/turf_decal/bot_white,
/turf/open/floor/iron/dark,
/area/station/hallway/secondary/entry)
"kE" = (
/turf/open/floor/iron/white/side{
	dir = 9
	},
/area/station/hallway/secondary/entry)
"lE" = (
/obj/machinery/atmospherics/pipe/smart/manifold4w/scrubbers/hidden/layer2,
/obj/machinery/atmospherics/pipe/smart/manifold4w/supply/hidden/layer4,
/obj/structure/cable,
/turf/open/floor/iron/white/side{
	dir = 4
	},
/area/station/hallway/secondary/entry)
"mJ" = (
/obj/structure/cable,
/obj/structure/railing{
	dir = 8
	},
/obj/effect/turf_decal/siding/brown{
	dir = 8
	},
/obj/machinery/atmospherics/pipe/smart/manifold4w/supply/hidden/layer4,
/obj/machinery/atmospherics/pipe/smart/manifold4w/scrubbers/hidden/layer2,
/obj/structure/disposalpipe/segment{
	dir = 5
	},
/turf/open/floor/iron/white/side{
	dir = 4
	},
/area/station/hallway/secondary/entry)
"nm" = (
/obj/structure/flora/bush/fullgrass/style_random,
/obj/structure/flora/bush/pale/style_random,
/obj/machinery/camera/autoname/directional/south,
/turf/open/floor/grass,
/area/station/hallway/secondary/entry)
"of" = (
/obj/machinery/atmospherics/pipe/smart/manifold4w/supply/hidden/layer4,
/obj/machinery/atmospherics/pipe/smart/manifold4w/scrubbers/hidden/layer2,
/obj/structure/cable,
/obj/effect/turf_decal/trimline/dark_blue/line{
	dir = 6
	},
/obj/effect/turf_decal/trimline/dark_blue/corner{
	dir = 4
	},
/turf/open/floor/iron/white,
/area/station/hallway/secondary/entry)
"ov" = (
/obj/machinery/atmospherics/pipe/smart/manifold4w/scrubbers/hidden/layer2,
/obj/machinery/atmospherics/pipe/smart/manifold4w/supply/hidden/layer4,
/turf/open/floor/iron/white/side{
	dir = 8
	},
/area/station/hallway/secondary/entry)
"qk" = (
/obj/structure/flora/bush/fullgrass/style_random,
/obj/structure/flora/bush/flowers_br/style_random,
/turf/open/floor/grass,
/area/station/hallway/secondary/entry)
"qR" = (
/obj/effect/turf_decal/tile/dark_blue{
	dir = 1
	},
/obj/machinery/vending/coffee,
/obj/effect/turf_decal/bot_white,
/turf/open/floor/iron/dark,
/area/station/hallway/secondary/entry)
"sj" = (
/obj/structure/flora/bush/ferny/style_random,
/obj/structure/flora/bush/fullgrass/style_random,
/obj/structure/flora/bush/ferny/style_random,
/obj/machinery/light/floor,
/turf/open/floor/grass,
/area/station/hallway/secondary/entry)
"tb" = (
/obj/structure/flora/bush/pale/style_random,
/obj/structure/flora/bush/fullgrass/style_random,
/obj/structure/flora/bush/ferny/style_random,
/turf/open/floor/grass,
/area/station/hallway/secondary/entry)
"tx" = (
/obj/structure/flora/bush/pale/style_random,
/obj/structure/flora/bush/fullgrass/style_random,
/turf/open/floor/grass,
/area/station/hallway/secondary/entry)
"tT" = (
/obj/machinery/atmospherics/pipe/smart/manifold4w/scrubbers/hidden/layer2,
/obj/machinery/atmospherics/pipe/smart/manifold4w/supply/hidden/layer4,
/obj/structure/disposalpipe/segment,
/obj/structure/cable,
/turf/open/floor/iron/white,
/area/station/hallway/secondary/entry)
"us" = (
/turf/open/floor/iron/white/side{
	dir = 5
	},
/area/station/hallway/secondary/entry)
"vF" = (
/turf/closed/wall/r_wall,
/area/station/hallway/secondary/entry)
"we" = (
/obj/structure/flora/bush/flowers_br/style_random,
/obj/structure/flora/bush/pale/style_random,
/obj/structure/flora/bush/fullgrass/style_random,
/turf/open/floor/grass,
/area/station/hallway/secondary/entry)
"wQ" = (
/obj/machinery/atmospherics/pipe/smart/manifold4w/scrubbers/hidden/layer2,
/obj/machinery/atmospherics/pipe/smart/manifold4w/supply/hidden/layer4,
/obj/structure/cable,
/obj/structure/disposalpipe/segment{
	dir = 10
	},
/obj/effect/turf_decal/trimline/dark_blue/line{
	dir = 10
	},
/obj/effect/turf_decal/trimline/dark_blue/corner{
	dir = 1
	},
/turf/open/floor/iron/white,
/area/station/hallway/secondary/entry)
"xN" = (
/obj/effect/spawner/random/vending/colavend,
/obj/effect/turf_decal/bot_white,
/turf/open/floor/iron/dark,
/area/station/hallway/secondary/entry)
"yr" = (
/obj/structure/railing{
	dir = 8
	},
/obj/effect/turf_decal/siding/brown{
	dir = 8
	},
/obj/item/kirbyplants/random,
/turf/open/floor/iron/white/corner{
	dir = 4
	},
/area/station/hallway/secondary/entry)
"ys" = (
/obj/machinery/light/floor,
/obj/effect/turf_decal/loading_area/white{
	color = "#52B4E9";
	dir = 8
	},
/turf/open/floor/plating,
/area/station/hallway/secondary/entry)
"zb" = (
/obj/structure/table,
/obj/effect/spawner/random/entertainment/cigarette_pack,
/obj/effect/turf_decal/bot_white,
/turf/open/floor/iron/dark,
/area/station/hallway/secondary/entry)
"zt" = (
/obj/structure/window/reinforced/spawner/directional/south,
/obj/structure/flora/bush/fullgrass/style_random,
/obj/structure/window/reinforced/spawner/directional/north,
/turf/open/floor/grass,
/area/station/hallway/secondary/entry)
"Ab" = (
/obj/machinery/vending/cigarette,
/obj/effect/turf_decal/bot_white,
/obj/effect/turf_decal/siding/dark_blue{
	dir = 8
	},
/turf/open/floor/iron/dark,
/area/station/hallway/secondary/entry)
"Af" = (
/obj/structure/flora/bush/fullgrass/style_random,
/obj/structure/flora/bush/ferny/style_random,
/turf/open/floor/grass,
/area/station/hallway/secondary/entry)
"CT" = (
/obj/structure/flora/bush/fullgrass/style_random,
/obj/structure/flora/bush/pale/style_random,
/turf/open/floor/grass,
/area/station/hallway/secondary/entry)
"Eb" = (
/obj/structure/table,
/obj/effect/spawner/random/food_or_drink,
/obj/effect/turf_decal/bot_white,
/turf/open/floor/iron/dark,
/area/station/hallway/secondary/entry)
"Ey" = (
/obj/machinery/door/airlock/external{
	name = "Arrival Airlock";
	space_dir = 4
	},
/obj/effect/mapping_helpers/airlock/cyclelink_helper{
	dir = 8
	},
/obj/effect/turf_decal/delivery/red,
/turf/open/floor/plating,
/area/station/hallway/secondary/entry)
"ED" = (
/obj/effect/turf_decal/stripes/line{
	dir = 4
	},
/obj/machinery/atmospherics/pipe/smart/manifold4w/supply/hidden/layer4,
/obj/machinery/atmospherics/pipe/smart/manifold4w/scrubbers/hidden/layer2,
/obj/structure/cable,
/obj/effect/turf_decal/tile/dark_blue{
	dir = 1
	},
/obj/effect/turf_decal/tile/dark_blue,
/turf/open/floor/iron/white,
/area/station/hallway/secondary/entry)
"Gh" = (
/obj/structure/flora/bush/ferny/style_random,
/obj/structure/flora/bush/fullgrass/style_random,
/obj/machinery/light/floor,
/turf/open/floor/grass,
/area/station/hallway/secondary/entry)
"GF" = (
/obj/machinery/atmospherics/pipe/smart/manifold4w/scrubbers/hidden/layer2,
/obj/structure/disposalpipe/segment{
	dir = 5
	},
/obj/machinery/atmospherics/pipe/smart/manifold4w/supply/hidden/layer4,
/obj/structure/cable,
/turf/open/floor/iron/white/side{
	dir = 5
	},
/area/station/hallway/secondary/entry)
"IX" = (
/obj/machinery/atmospherics/pipe/smart/manifold4w/supply/hidden/layer4,
/obj/machinery/atmospherics/pipe/smart/manifold4w/scrubbers/hidden/layer2,
/obj/structure/cable,
/obj/effect/turf_decal/tile/dark_blue{
	dir = 1
	},
/obj/effect/turf_decal/tile/dark_blue,
/obj/effect/turf_decal/stripes/corner,
/turf/open/floor/iron/white,
/area/station/hallway/secondary/entry)
"Lq" = (
/obj/machinery/atmospherics/pipe/smart/manifold4w/scrubbers/hidden/layer2,
/obj/machinery/atmospherics/pipe/smart/manifold4w/supply/hidden/layer4,
/obj/effect/turf_decal/trimline/blue/filled/corner{
	dir = 1
	},
/obj/structure/cable,
/turf/open/floor/iron/white/side{
	dir = 4
	},
/area/station/hallway/secondary/entry)
"LT" = (
/obj/machinery/atmospherics/pipe/smart/manifold4w/scrubbers/hidden/layer2,
/obj/machinery/atmospherics/pipe/smart/manifold4w/supply/hidden/layer4,
/obj/effect/turf_decal/caution{
	dir = 4
	},
/obj/structure/cable,
/turf/open/floor/iron/white/side{
	dir = 4
	},
/area/station/hallway/secondary/entry)
"Mp" = (
/obj/machinery/atmospherics/pipe/smart/manifold4w/scrubbers/hidden/layer2,
/obj/machinery/atmospherics/pipe/smart/manifold4w/supply/hidden/layer4,
/obj/effect/turf_decal/trimline/blue/filled/corner{
	dir = 4
	},
/turf/open/floor/iron/white/side{
	dir = 8
	},
/area/station/hallway/secondary/entry)
"NZ" = (
/obj/machinery/status_display/shuttle/directional/west,
/obj/machinery/vending/coffee,
/obj/effect/turf_decal/bot_white,
/turf/open/floor/iron/dark,
/area/station/hallway/secondary/entry)
"OD" = (
/obj/machinery/light/floor,
/obj/effect/turf_decal/loading_area/white{
	color = "#52B4E9";
	dir = 4
	},
/turf/open/floor/plating,
/area/station/hallway/secondary/entry)
"OP" = (
/obj/machinery/atmospherics/pipe/smart/manifold4w/supply/hidden/layer4,
/obj/machinery/atmospherics/pipe/smart/manifold4w/scrubbers/hidden/layer2,
/obj/structure/cable,
/obj/effect/turf_decal/trimline/dark_blue/corner{
	dir = 1
	},
/turf/open/floor/iron/white,
/area/station/hallway/secondary/entry)
"OU" = (
/obj/structure/flora/bush/ferny/style_random,
/obj/structure/flora/bush/fullgrass/style_random,
/obj/structure/flora/bush/flowers_br/style_random,
/turf/open/floor/grass,
/area/station/hallway/secondary/entry)
"Pq" = (
/obj/structure/flora/bush/flowers_br/style_random,
/obj/structure/flora/bush/ferny/style_random,
/obj/structure/flora/bush/fullgrass/style_random,
/turf/open/floor/grass,
/area/station/hallway/secondary/entry)
"PD" = (
/obj/machinery/door/airlock/external{
	name = "Arrival Airlock";
	space_dir = 8
	},
/obj/effect/mapping_helpers/airlock/cyclelink_helper{
	dir = 4
	},
/obj/effect/turf_decal/delivery/red,
/turf/open/floor/plating,
/area/station/hallway/secondary/entry)
"Qr" = (
/obj/structure/railing{
	dir = 4
	},
/obj/effect/turf_decal/siding/brown{
	dir = 4
	},
/obj/machinery/atmospherics/pipe/smart/manifold4w/supply/hidden/layer4,
/obj/machinery/atmospherics/pipe/smart/manifold4w/scrubbers/hidden/layer2,
/obj/structure/cable,
/turf/open/floor/iron/white/side{
	dir = 8
	},
/area/station/hallway/secondary/entry)
"RV" = (
/obj/structure/cable,
/obj/machinery/atmospherics/pipe/smart/manifold4w/scrubbers/hidden/layer2,
/obj/machinery/atmospherics/pipe/smart/manifold4w/supply/hidden/layer4,
/obj/structure/disposalpipe/segment{
	dir = 4
	},
/obj/effect/turf_decal/trimline/dark_blue/corner{
	dir = 4
	},
/turf/open/floor/iron/white,
/area/station/hallway/secondary/entry)
"Sk" = (
/obj/machinery/door/airlock/external{
	name = "Arrival Airlock"
	},
/obj/effect/mapping_helpers/airlock/cyclelink_helper{
	dir = 8
	},
/obj/effect/turf_decal/delivery/red,
/turf/open/floor/plating,
/area/station/hallway/secondary/entry)
"SX" = (
/obj/effect/spawner/structure/window/reinforced,
/turf/open/floor/plating,
/area/station/hallway/secondary/entry)
"Tw" = (
/obj/machinery/door/airlock/external{
	name = "Arrival Airlock"
	},
/obj/effect/mapping_helpers/airlock/cyclelink_helper{
	dir = 4
	},
/obj/effect/turf_decal/delivery/red,
/turf/open/floor/plating,
/area/station/hallway/secondary/entry)
"TP" = (
/obj/structure/flora/bush/ferny/style_random,
/obj/structure/flora/bush/fullgrass/style_random,
/obj/structure/flora/bush/pale/style_random,
/turf/open/floor/grass,
/area/station/hallway/secondary/entry)
"Vn" = (
/obj/machinery/computer/shuttle/arrivals/recall{
	dir = 4
	},
/obj/effect/turf_decal/bot_white,
/turf/open/floor/iron/dark,
/area/station/hallway/secondary/entry)
"WB" = (
/obj/machinery/atmospherics/pipe/smart/manifold4w/scrubbers/hidden/layer2,
/obj/machinery/atmospherics/pipe/smart/manifold4w/supply/hidden/layer4,
/obj/effect/turf_decal/trimline/blue/filled/warning{
	dir = 8
	},
/obj/structure/cable,
/turf/open/floor/iron/white/side{
	dir = 4
	},
/area/station/hallway/secondary/entry)
"YT" = (
/obj/machinery/atmospherics/pipe/smart/manifold4w/scrubbers/hidden/layer2,
/obj/machinery/atmospherics/pipe/smart/manifold4w/supply/hidden/layer4,
/obj/effect/turf_decal/trimline/blue/filled/warning{
	dir = 4
	},
/turf/open/floor/iron/white/side{
	dir = 8
	},
/area/station/hallway/secondary/entry)
"YZ" = (
/obj/structure/window/reinforced/spawner/directional/south,
/obj/structure/window/reinforced/spawner/directional/north,
/obj/structure/flora/bush/flowers_br/style_random,
/turf/open/floor/grass,
/area/station/hallway/secondary/entry)
"ZN" = (
/obj/structure/window/reinforced/spawner/directional/south,
/obj/structure/flora/bush/ferny/style_random,
/obj/structure/window/reinforced/spawner/directional/north,
/turf/open/floor/grass,
/area/station/hallway/secondary/entry)

(1,1,1) = {"
of
IX
gL
gL
ED
ED
ED
YT
Mp
ov
"}
(2,1,1) = {"
OP
kE
qR
ky
zb
cN
SX
Tw
SX
Ab
"}
(3,1,1) = {"
Qr
fj
vF
vF
SX
vF
SX
ys
SX
SX
"}
(4,1,1) = {"
we
CT
zt
hX
hX
hX
SX
Ey
SX
hX
"}
(5,1,1) = {"
tx
OU
YZ
hX
hX
hX
hX
hX
hX
hX
"}
(6,1,1) = {"
TP
aV
ZN
hX
hX
hX
hX
hX
hX
hX
"}
(7,1,1) = {"
qk
fa
YZ
hX
hX
hX
hX
hX
hX
hX
"}
(8,1,1) = {"
Gh
nm
vF
hX
hX
hX
hX
hX
hX
hX
"}
(9,1,1) = {"
tb
qk
YZ
hX
hX
hX
hX
hX
hX
hX
"}
(10,1,1) = {"
tx
sj
zt
hX
hX
el
hX
hX
hX
hX
"}
(11,1,1) = {"
OU
CT
YZ
hX
hX
hX
hX
hX
hX
hX
"}
(12,1,1) = {"
Af
Pq
zt
hX
hX
hX
SX
PD
SX
hX
"}
(13,1,1) = {"
mJ
yr
vF
vF
SX
vF
SX
OD
SX
SX
"}
(14,1,1) = {"
RV
us
NZ
xN
Eb
Vn
SX
Sk
SX
fb
"}
(15,1,1) = {"
wQ
tT
GF
lE
LT
lE
dT
WB
Lq
lE
"}
