//MAP CONVERTED BY dmm2tgm.py THIS HEADER COMMENT PREVENTS RECONVERSION, DO NOT REMOVE
"a" = (
/obj/structure/disposalpipe/segment{
	dir = 4
	},
/turf/closed/wall,
/area/station/command/heads_quarters/nt_rep)
"b" = (
/obj/structure/cable,
/obj/machinery/atmospherics/pipe/smart/manifold4w/supply/hidden/layer4,
/obj/machinery/atmospherics/pipe/smart/manifold4w/scrubbers/hidden/layer2,
/turf/open/floor/iron/large,
/area/station/hallway/primary/central)
"c" = (
/obj/machinery/atmospherics/pipe/smart/manifold4w/supply/hidden/layer4,
/obj/effect/turf_decal/siding/wood/corner{
	dir = 1
	},
/obj/effect/turf_decal/siding/wood,
/obj/structure/cable,
/turf/open/floor/wood,
/area/station/command/heads_quarters/nt_rep)
"d" = (
/obj/structure/cable,
/obj/machinery/atmospherics/pipe/smart/manifold4w/supply/hidden/layer4,
/obj/machinery/atmospherics/pipe/smart/manifold4w/scrubbers/hidden/layer2,
/obj/effect/turf_decal/siding/wood{
	dir = 1
	},
/obj/effect/turf_decal/siding/wood,
/turf/open/floor/wood,
/area/station/command/heads_quarters/nt_rep)
"f" = (
/turf/open/floor/iron/large,
/area/station/hallway/primary/central)
"g" = (
/turf/open/floor/wood,
/area/station/hallway/primary/central)
"h" = (
/obj/structure/table/wood,
/obj/item/paper_bin{
	pixel_y = 4
	},
/obj/item/pen/fountain,
/turf/open/floor/carpet/executive,
/area/station/command/heads_quarters/nt_rep)
"i" = (
/obj/machinery/airalarm/directional/east,
/obj/machinery/photocopier/prebuilt,
/obj/effect/turf_decal/siding/wood{
	dir = 6
	},
/turf/open/floor/wood,
/area/station/command/heads_quarters/nt_rep)
"j" = (
/obj/machinery/firealarm/directional/west,
/turf/template_noop,
/area/template_noop)
"n" = (
/obj/structure/cable,
/obj/machinery/door/airlock/maintenance,
/obj/effect/mapping_helpers/airlock/access/all/cent_com/rep_door,
/turf/open/floor/plating,
/area/station/command/heads_quarters/nt_rep)
"r" = (
/obj/effect/turf_decal/siding/wood{
	dir = 8
	},
/obj/machinery/holopad,
/turf/open/floor/wood,
/area/station/command/heads_quarters/nt_rep)
"s" = (
/obj/structure/cable,
/obj/machinery/atmospherics/components/unary/vent_scrubber/on/layer2{
	dir = 4
	},
/obj/effect/turf_decal/siding/wood{
	dir = 1
	},
/obj/effect/turf_decal/siding/wood,
/turf/open/floor/wood,
/area/station/command/heads_quarters/nt_rep)
"u" = (
/obj/effect/turf_decal/siding/wood{
	dir = 9
	},
/obj/machinery/light/directional/north,
/turf/open/floor/wood,
/area/station/command/heads_quarters/nt_rep)
"v" = (
/turf/template_noop,
/area/template_noop)
"w" = (
/obj/structure/filingcabinet/chestdrawer,
/turf/open/floor/carpet/executive,
/area/station/command/heads_quarters/nt_rep)
"x" = (
/turf/open/floor/carpet/executive,
/area/station/command/heads_quarters/nt_rep)
"y" = (
/obj/effect/spawner/structure/window/reinforced{
	polarizer_id = "catwalkntrep"
	},
/turf/open/floor/plating,
/area/station/command/heads_quarters/nt_rep)
"z" = (
/obj/effect/turf_decal/siding/wood{
	dir = 4
	},
/obj/item/radio/intercom/directional/north,
/turf/open/floor/iron/large,
/area/station/hallway/primary/central)
"A" = (
/obj/machinery/door/airlock/corporate{
	name = "NT Consultant's Office"
	},
/obj/structure/cable,
/obj/machinery/atmospherics/pipe/smart/manifold4w/scrubbers/hidden/layer2,
/obj/effect/mapping_helpers/airlock/access/all/cent_com/rep_door,
/obj/machinery/door/firedoor,
/obj/machinery/atmospherics/pipe/smart/manifold4w/supply/hidden/layer4,
/obj/effect/landmark/navigate_destination,
/turf/open/floor/iron,
/area/station/command/heads_quarters/nt_rep)
"B" = (
/obj/machinery/button/polarizer{
	id = "catwalkntrep";
	pixel_y = 24
	},
/obj/machinery/light/directional/north,
/turf/open/floor/carpet/executive,
/area/station/command/heads_quarters/nt_rep)
"D" = (
/obj/structure/chair/office{
	dir = 8
	},
/obj/effect/landmark/start/nanotrasen_consultant,
/turf/open/floor/carpet/executive,
/area/station/command/heads_quarters/nt_rep)
"E" = (
/obj/effect/turf_decal/siding/wood{
	dir = 8
	},
/turf/open/floor/iron/large,
/area/station/hallway/primary/central)
"F" = (
/obj/machinery/light_switch/directional/east,
/obj/effect/turf_decal/siding/wood{
	dir = 4
	},
/obj/structure/cable,
/turf/open/floor/wood,
/area/station/command/heads_quarters/nt_rep)
"H" = (
/obj/machinery/atmospherics/components/unary/vent_pump/on/layer4,
/obj/effect/turf_decal/siding/wood{
	dir = 8
	},
/obj/structure/cable,
/turf/open/floor/wood,
/area/station/command/heads_quarters/nt_rep)
"I" = (
/obj/structure/table/wood,
/obj/machinery/fax{
	fax_name = "Nanotrasen Consultant's Office";
	name = "Nanotrasen Consultant's Fax Machine"
	},
/obj/machinery/firealarm/directional/west,
/turf/open/floor/carpet/executive,
/area/station/command/heads_quarters/nt_rep)
"L" = (
/obj/structure/closet/secure_closet/nanotrasen_consultant,
/turf/open/floor/carpet/executive,
/area/station/command/heads_quarters/nt_rep)
"M" = (
/turf/closed/wall,
/area/station/command/heads_quarters/nt_rep)
"P" = (
/obj/machinery/atmospherics/components/unary/vent_pump/on/layer4,
/obj/machinery/ticket_machine/directional/north{
	id = "ticket_machine_comissary"
	},
/obj/machinery/camera/autoname/directional/north,
/turf/open/floor/wood,
/area/station/hallway/primary/central)
"Q" = (
/obj/structure/table/wood,
/obj/item/stamp{
	pixel_x = -2;
	pixel_y = 6
	},
/obj/item/stamp/denied{
	pixel_x = 8;
	pixel_y = 6
	},
/obj/item/stamp/centcom{
	pixel_x = 4
	},
/turf/open/floor/carpet/executive,
/area/station/command/heads_quarters/nt_rep)
"T" = (
/obj/item/kirbyplants/random,
/obj/effect/turf_decal/siding/wood{
	dir = 5
	},
/turf/open/floor/wood,
/area/station/command/heads_quarters/nt_rep)
"X" = (
/obj/effect/turf_decal/siding/wood{
	dir = 4
	},
/obj/structure/cable,
/turf/open/floor/wood,
/area/station/command/heads_quarters/nt_rep)
"Y" = (
/obj/structure/cable,
/obj/machinery/power/apc/auto_name/directional/west,
/obj/structure/chair/office{
	dir = 4
	},
/obj/effect/turf_decal/siding/wood/end{
	dir = 8
	},
/turf/open/floor/wood,
/area/station/command/heads_quarters/nt_rep)
"Z" = (
/obj/structure/table/wood,
/obj/item/flashlight/lamp/green,
/turf/open/floor/carpet/executive,
/area/station/command/heads_quarters/nt_rep)

(1,1,1) = {"
M
M
a
M
M
M
P
"}
(2,1,1) = {"
M
L
w
I
Y
y
g
"}
(3,1,1) = {"
M
B
D
h
s
y
E
"}
(4,1,1) = {"
M
x
Z
Q
d
A
b
"}
(5,1,1) = {"
M
u
r
H
c
y
f
"}
(6,1,1) = {"
M
T
X
F
i
y
f
"}
(7,1,1) = {"
M
M
n
M
M
M
z
"}
(8,1,1) = {"
v
v
v
j
v
v
v
"}
