//MAP CONVERTED BY dmm2tgm.py THIS HEADER COMMENT PREVENTS RECONVERSION, DO NOT REMOVE
"a" = (
/turf/closed/wall,
/area/station/service/barber)
"c" = (
/obj/machinery/door/airlock/maintenance,
/obj/effect/mapping_helpers/airlock/access/any/service/maintenance,
/obj/structure/disposalpipe/segment{
	dir = 4
	},
/obj/effect/mapping_helpers/airlock/unres{
	dir = 8
	},
/turf/open/floor/plating,
/area/station/service/barber)
"g" = (
/obj/effect/turf_decal/tile/purple{
	dir = 1
	},
/obj/effect/turf_decal/tile/purple,
/obj/machinery/vending/barbervend,
/turf/open/floor/iron/dark,
/area/station/service/barber)
"i" = (
/obj/effect/turf_decal/tile/purple{
	dir = 1
	},
/obj/effect/turf_decal/tile/purple,
/obj/machinery/light/directional/east,
/turf/open/floor/iron/dark,
/area/station/service/barber)
"j" = (
/obj/effect/turf_decal/tile/purple{
	dir = 1
	},
/obj/effect/turf_decal/tile/purple,
/obj/structure/table/glass,
/obj/structure/mirror/directional/east,
/obj/item/hairbrush/comb{
	pixel_y = 10
	},
/obj/item/lipstick/random,
/turf/open/floor/iron/dark,
/area/station/service/barber)
"m" = (
/obj/effect/turf_decal/tile/purple{
	dir = 1
	},
/obj/effect/turf_decal/tile/purple,
/obj/structure/closet/secure_closet/barber,
/turf/open/floor/iron/dark,
/area/station/service/barber)
"n" = (
/obj/effect/turf_decal/tile/purple{
	dir = 1
	},
/obj/effect/turf_decal/tile/purple,
/obj/machinery/power/apc/auto_name/directional/west,
/obj/structure/cable,
/obj/machinery/atmospherics/pipe/smart/manifold4w/supply/hidden/layer4,
/turf/open/floor/iron/dark,
/area/station/service/barber)
"o" = (
/obj/structure/cable,
/turf/template_noop,
/area/template_noop)
"q" = (
/obj/structure/disposalpipe/segment,
/obj/effect/turf_decal/tile/purple,
/obj/effect/turf_decal/tile/purple{
	dir = 1
	},
/obj/structure/cable,
/obj/machinery/atmospherics/pipe/smart/manifold4w/supply/hidden/layer4,
/obj/machinery/atmospherics/pipe/smart/manifold4w/scrubbers/hidden/layer2,
/obj/machinery/light_switch/directional/west,
/turf/open/floor/iron/dark,
/area/station/service/barber)
"r" = (
/obj/effect/turf_decal/trimline/red/filled/line{
	dir = 1
	},
/turf/open/floor/iron,
/area/station/hallway/primary/port)
"s" = (
/obj/structure/disposalpipe/segment{
	dir = 10
	},
/obj/effect/turf_decal/tile/purple,
/obj/effect/turf_decal/tile/purple{
	dir = 1
	},
/obj/structure/cable,
/obj/machinery/atmospherics/pipe/smart/manifold4w/supply/hidden/layer4,
/obj/machinery/atmospherics/pipe/smart/manifold4w/scrubbers/hidden/layer2,
/turf/open/floor/iron/dark,
/area/station/service/barber)
"t" = (
/obj/structure/disposalpipe/segment,
/obj/machinery/door/airlock/public/glass{
	name = "Barbershop"
	},
/obj/structure/cable,
/obj/machinery/atmospherics/pipe/smart/manifold4w/supply/hidden/layer4,
/obj/machinery/atmospherics/pipe/smart/manifold4w/scrubbers/hidden/layer2,
/obj/effect/landmark/navigate_destination,
/turf/open/floor/plating,
/area/station/service/barber)
"x" = (
/obj/structure/closet/firecloset,
/obj/effect/turf_decal/trimline/red/filled/line{
	dir = 1
	},
/obj/effect/turf_decal/trimline/red/line,
/obj/effect/landmark/start/hangover,
/obj/machinery/status_display/evac/directional/north,
/turf/open/floor/iron,
/area/station/service/barber)
"y" = (
/obj/effect/turf_decal/tile/purple{
	dir = 1
	},
/obj/effect/turf_decal/tile/purple,
/obj/structure/table/glass,
/obj/structure/mirror/directional/east,
/obj/item/hairbrush,
/turf/open/floor/iron/dark,
/area/station/service/barber)
"C" = (
/obj/structure/closet/emcloset,
/obj/effect/turf_decal/trimline/red/filled/line{
	dir = 9
	},
/obj/effect/turf_decal/trimline/red/corner,
/obj/machinery/airalarm/directional/west,
/obj/effect/landmark/start/hangover,
/turf/open/floor/iron,
/area/station/service/barber)
"D" = (
/obj/effect/turf_decal/tile/purple{
	dir = 1
	},
/obj/effect/turf_decal/tile/purple,
/turf/open/floor/iron/dark,
/area/station/service/barber)
"E" = (
/obj/machinery/door/airlock/maintenance,
/obj/effect/mapping_helpers/airlock/access/any/service/maintenance,
/obj/effect/mapping_helpers/airlock/unres{
	dir = 1
	},
/turf/open/floor/plating,
/area/station/service/barber)
"H" = (
/obj/effect/turf_decal/tile/purple{
	dir = 1
	},
/obj/effect/turf_decal/tile/purple,
/obj/item/kirbyplants/random,
/turf/open/floor/iron/dark,
/area/station/service/barber)
"I" = (
/obj/structure/cable,
/obj/machinery/atmospherics/pipe/smart/manifold4w/supply/hidden/layer4,
/obj/machinery/atmospherics/pipe/smart/manifold4w/scrubbers/hidden/layer2,
/turf/template_noop,
/area/template_noop)
"J" = (
/obj/effect/turf_decal/tile/purple{
	dir = 1
	},
/obj/effect/turf_decal/tile/purple,
/obj/structure/chair/comfy/barber_chair{
	dir = 4
	},
/turf/open/floor/iron/dark,
/area/station/service/barber)
"P" = (
/turf/template_noop,
/area/template_noop)
"S" = (
/obj/effect/spawner/structure/window,
/turf/open/floor/plating,
/area/station/service/barber)
"U" = (
/obj/effect/turf_decal/tile/purple{
	dir = 1
	},
/obj/effect/turf_decal/tile/purple,
/obj/machinery/light/directional/west,
/obj/machinery/atmospherics/pipe/smart/manifold4w/supply/hidden/layer4,
/turf/open/floor/iron/dark,
/area/station/service/barber)
"W" = (
/obj/effect/turf_decal/tile/purple{
	dir = 1
	},
/obj/effect/turf_decal/tile/purple,
/obj/effect/landmark/start/barber,
/turf/open/floor/iron/dark,
/area/station/service/barber)
"X" = (
/obj/effect/turf_decal/tile/purple{
	dir = 1
	},
/obj/effect/turf_decal/tile/purple,
/obj/machinery/atmospherics/components/unary/vent_pump/on/layer4{
	dir = 8
	},
/turf/open/floor/iron/dark,
/area/station/service/barber)
"Z" = (
/obj/effect/turf_decal/tile/purple,
/obj/effect/turf_decal/tile/purple{
	dir = 1
	},
/obj/machinery/airalarm/directional/east,
/obj/machinery/atmospherics/components/unary/vent_scrubber/on/layer2{
	dir = 8
	},
/turf/open/floor/iron/dark,
/area/station/service/barber)

(1,1,1) = {"
a
a
a
a
c
a
a
P
P
"}
(2,1,1) = {"
a
g
U
n
s
q
t
I
o
"}
(3,1,1) = {"
a
m
X
W
D
Z
S
r
P
"}
(4,1,1) = {"
E
D
D
J
J
a
a
P
P
"}
(5,1,1) = {"
a
H
i
y
j
a
C
P
P
"}
(6,1,1) = {"
a
a
a
a
a
a
x
P
P
"}
