//MAP CONVERTED BY dmm2tgm.py THIS HEADER COMMENT PREVENTS RECONVERSION, DO NOT REMOVE
"ae" = (
/obj/structure/table/wood,
/obj/machinery/atmospherics/pipe/smart/manifold4w/scrubbers/hidden/layer2,
/obj/structure/cable,
/obj/machinery/atmospherics/pipe/smart/manifold4w/supply/hidden/layer4,
/obj/effect/decal/cleanable/dirt/dust,
/obj/effect/decal/cleanable/dirt/dust,
/obj/effect/decal/cleanable/dirt,
/obj/effect/decal/cleanable/dirt,
/turf/open/floor/carpet/executive,
/area/station/command/heads_quarters/nt_rep)
"gh" = (
/obj/effect/turf_decal/siding/wood,
/obj/machinery/power/apc/auto_name/directional/east,
/obj/structure/cable,
/obj/effect/decal/cleanable/dirt/dust,
/obj/effect/decal/cleanable/dirt/dust,
/obj/effect/decal/cleanable/dirt,
/turf/open/floor/wood/large,
/area/station/command/heads_quarters/nt_rep)
"iS" = (
/obj/effect/spawner/structure/window/reinforced,
/obj/machinery/door/poddoor/preopen{
	id = "nt_rep_priv";
	name = "Privacy Shutter"
	},
/turf/open/floor/plating,
/area/station/command/heads_quarters/nt_rep)
"nh" = (
/obj/machinery/atmospherics/pipe/smart/manifold4w/scrubbers/hidden/layer2,
/obj/structure/cable,
/obj/machinery/atmospherics/pipe/smart/manifold4w/supply/hidden/layer4,
/obj/effect/landmark/start/nanotrasen_consultant,
/obj/effect/decal/cleanable/dirt,
/turf/open/floor/carpet/executive,
/area/station/command/heads_quarters/nt_rep)
"nw" = (
/obj/structure/table/wood,
/obj/item/clipboard{
	pixel_x = -7;
	pixel_y = 4
	},
/obj/item/stamp/centcom{
	pixel_y = 8;
	pixel_x = -7
	},
/obj/item/stamp{
	pixel_x = 12;
	pixel_y = 11
	},
/obj/item/stamp/denied{
	pixel_x = 10;
	pixel_y = 4
	},
/obj/effect/decal/cleanable/dirt/dust,
/obj/effect/decal/cleanable/dirt,
/obj/effect/decal/cleanable/dirt,
/turf/open/floor/carpet/executive,
/area/station/command/heads_quarters/nt_rep)
"sZ" = (
/turf/closed/wall/r_wall,
/area/station/command/heads_quarters/nt_rep)
"ti" = (
/obj/machinery/photocopier/prebuilt,
/obj/effect/decal/cleanable/dirt,
/turf/open/floor/carpet/executive,
/area/station/command/heads_quarters/nt_rep)
"wx" = (
/obj/item/kirbyplants/organic/plant22,
/obj/machinery/light/directional/west,
/obj/effect/decal/cleanable/dirt/dust,
/obj/effect/decal/cleanable/dirt,
/obj/machinery/airalarm/directional/west,
/turf/open/floor/wood/large,
/area/station/command/heads_quarters/nt_rep)
"Dp" = (
/obj/machinery/atmospherics/pipe/smart/manifold4w/scrubbers/hidden/layer2,
/obj/structure/cable,
/obj/effect/landmark/start/nanotrasen_consultant,
/obj/effect/decal/cleanable/dirt/dust,
/turf/open/floor/wood/large,
/area/station/command/heads_quarters/nt_rep)
"Ds" = (
/obj/effect/turf_decal/siding/wood,
/obj/machinery/atmospherics/components/unary/vent_pump/on/layer4{
	dir = 4
	},
/obj/structure/filingcabinet/chestdrawer,
/turf/open/floor/wood/large,
/area/station/command/heads_quarters/nt_rep)
"Et" = (
/obj/effect/mapping_helpers/airlock/access/all/cent_com/rep_door,
/obj/machinery/door/airlock{
	name = "Maintenance"
	},
/obj/machinery/atmospherics/pipe/smart/manifold4w/supply/hidden/layer4,
/obj/machinery/atmospherics/pipe/smart/manifold4w/scrubbers/hidden/layer2,
/obj/structure/cable,
/turf/open/floor/plating,
/area/station/command/heads_quarters/nt_rep)
"EK" = (
/obj/machinery/atmospherics/pipe/smart/manifold4w/scrubbers/hidden/layer2,
/obj/structure/cable,
/obj/machinery/atmospherics/pipe/smart/manifold4w/supply/hidden/layer4,
/obj/effect/decal/cleanable/dirt/dust,
/obj/effect/decal/cleanable/dirt,
/turf/open/floor/carpet/executive,
/area/station/command/heads_quarters/nt_rep)
"FF" = (
/obj/structure/table/wood,
/obj/machinery/fax{
	fax_name = "Nanotrasen Consultant's Office";
	name = "Nanotrasen Consultant's Fax Machine"
	},
/obj/machinery/atmospherics/components/unary/vent_scrubber/on/layer2{
	dir = 4
	},
/obj/machinery/button/door/directional/west{
	id = "nt_rep_priv";
	name = "Privacy Shutters Control"
	},
/obj/effect/decal/cleanable/dirt,
/turf/open/floor/carpet/executive,
/area/station/command/heads_quarters/nt_rep)
"FO" = (
/obj/structure/sign/calendar/directional/south,
/obj/effect/landmark/start/nanotrasen_consultant,
/obj/effect/decal/cleanable/dirt/dust,
/turf/open/floor/carpet/executive,
/area/station/command/heads_quarters/nt_rep)
"Ht" = (
/obj/effect/decal/cleanable/dirt/dust,
/obj/effect/decal/cleanable/dirt/dust,
/obj/effect/decal/cleanable/dirt,
/obj/effect/decal/cleanable/ants,
/turf/open/floor/wood/large,
/area/station/command/heads_quarters/nt_rep)
"HH" = (
/obj/item/radio/intercom/directional/west,
/obj/structure/table/wood,
/obj/item/paper_bin/carbon{
	pixel_y = 4;
	pixel_x = -4
	},
/obj/item/pen/fountain{
	pixel_x = -4;
	pixel_y = 6
	},
/turf/open/floor/carpet/executive,
/area/station/command/heads_quarters/nt_rep)
"OS" = (
/obj/structure/chair/comfy/black{
	dir = 1
	},
/obj/machinery/atmospherics/pipe/smart/manifold4w/scrubbers/hidden/layer2,
/obj/effect/landmark/start/nanotrasen_consultant,
/obj/effect/decal/cleanable/dirt/dust,
/obj/effect/decal/cleanable/dirt,
/turf/open/floor/carpet/executive,
/area/station/command/heads_quarters/nt_rep)
"Pd" = (
/obj/effect/turf_decal/siding/wood,
/obj/structure/chair/office,
/obj/machinery/atmospherics/pipe/smart/manifold4w/scrubbers/hidden/layer2,
/obj/structure/cable,
/obj/machinery/atmospherics/pipe/smart/manifold4w/supply/hidden/layer4,
/obj/effect/decal/cleanable/dirt/dust,
/obj/effect/decal/cleanable/dirt/dust,
/turf/open/floor/wood/large,
/area/station/command/heads_quarters/nt_rep)
"QJ" = (
/obj/machinery/door/airlock/corporate{
	name = "NT Consultant's Office"
	},
/obj/effect/turf_decal/siding/thinplating,
/obj/machinery/door/firedoor,
/obj/structure/disposalpipe/segment,
/obj/structure/cable,
/obj/effect/mapping_helpers/airlock/access/all/cent_com/rep_door,
/obj/machinery/atmospherics/pipe/smart/manifold4w/scrubbers/hidden/layer2,
/turf/open/floor/iron/textured_half,
/area/station/command/heads_quarters/nt_rep)
"TT" = (
/obj/machinery/atmospherics/components/unary/vent_pump/on/layer4{
	dir = 1
	},
/obj/structure/sign/clock/directional/south,
/obj/machinery/light/directional/south,
/obj/effect/decal/cleanable/dirt/dust,
/turf/open/floor/carpet/executive,
/area/station/command/heads_quarters/nt_rep)
"VM" = (
/obj/effect/decal/cleanable/dirt/dust,
/obj/effect/decal/cleanable/dirt,
/obj/machinery/firealarm/directional/east,
/turf/open/floor/carpet/executive,
/area/station/command/heads_quarters/nt_rep)
"Yp" = (
/obj/effect/turf_decal/siding/wood,
/obj/structure/chair/office,
/obj/machinery/atmospherics/pipe/smart/manifold4w/supply/hidden/layer4,
/obj/effect/decal/cleanable/dirt/dust,
/obj/effect/decal/cleanable/dirt,
/turf/open/floor/wood/large,
/area/station/command/heads_quarters/nt_rep)
"Zf" = (
/obj/structure/filingcabinet/employment,
/obj/effect/decal/cleanable/dirt,
/turf/open/floor/carpet/executive,
/area/station/command/heads_quarters/nt_rep)
"ZQ" = (
/obj/item/kirbyplants/organic/plant22,
/obj/machinery/atmospherics/components/unary/vent_scrubber/on/layer2{
	dir = 8
	},
/obj/machinery/light_switch/directional/east,
/obj/effect/decal/cleanable/cobweb/cobweb2,
/turf/open/floor/wood/large,
/area/station/command/heads_quarters/nt_rep)

(1,1,1) = {"
sZ
sZ
sZ
sZ
sZ
sZ
sZ
"}
(2,1,1) = {"
iS
wx
Ds
HH
FF
ti
sZ
"}
(3,1,1) = {"
iS
Ht
Yp
nw
OS
FO
sZ
"}
(4,1,1) = {"
QJ
Dp
Pd
ae
EK
TT
sZ
"}
(5,1,1) = {"
iS
ZQ
gh
VM
nh
Zf
sZ
"}
(6,1,1) = {"
sZ
sZ
sZ
sZ
Et
sZ
sZ
"}
