//MAP CONVERTED BY dmm2tgm.py THIS HEADER COMMENT PREVENTS RECONVERSION, DO NOT REMOVE
"cT" = (
/obj/structure/mirror/directional/east,
/obj/structure/table/glass,
/obj/item/hairbrush/comb{
	pixel_y = -1;
	pixel_x = -3
	},
/turf/open/floor/iron/dark/small,
/area/station/service/barber)
"ds" = (
/obj/structure/mirror/directional/east,
/obj/structure/table/glass,
/obj/effect/mapping_helpers/broken_floor,
/obj/item/reagent_containers/spray/quantum_hair_dye{
	pixel_x = 9;
	pixel_y = 16
	},
/turf/open/floor/iron/dark/small,
/area/station/service/barber)
"eJ" = (
/obj/structure/cable,
/obj/machinery/atmospherics/pipe/smart/manifold4w/supply/hidden/layer4,
/turf/open/floor/plating,
/area/station/service/barber)
"fn" = (
/obj/machinery/atmospherics/components/unary/vent_pump/on/layer4{
	dir = 8
	},
/obj/effect/turf_decal/siding/wood{
	dir = 4
	},
/turf/open/floor/wood/large,
/area/station/service/barber)
"lK" = (
/obj/effect/mapping_helpers/broken_floor,
/obj/structure/chair/comfy/barber_chair{
	dir = 4
	},
/turf/open/floor/iron/dark/small,
/area/station/service/barber)
"na" = (
/obj/effect/turf_decal/siding/wood{
	dir = 4
	},
/obj/machinery/button/curtain{
	id = "barbershopcurtains";
	pixel_y = 26;
	dir = 8
	},
/obj/machinery/light/small/directional/north,
/turf/open/floor/wood/large,
/area/station/service/barber)
"ri" = (
/obj/machinery/atmospherics/components/unary/vent_scrubber/on/layer2{
	dir = 8
	},
/obj/effect/turf_decal/siding/wood{
	dir = 4
	},
/turf/open/floor/wood/large,
/area/station/service/barber)
"wI" = (
/obj/effect/spawner/structure/window,
/obj/structure/curtain/cloth/fancy/mechanical{
	id = "barbershopcurtains"
	},
/turf/open/floor/plating,
/area/station/service/barber)
"wL" = (
/turf/closed/wall,
/area/station/commons/fitness/locker_room)
"xN" = (
/obj/machinery/power/apc/auto_name/directional/north,
/obj/structure/cable,
/obj/effect/landmark/start/barber,
/turf/open/floor/wood/large,
/area/station/service/barber)
"yf" = (
/obj/effect/mapping_helpers/burnt_floor,
/obj/structure/chair/sofa/bench/right{
	dir = 4
	},
/obj/effect/landmark/start/assistant,
/obj/machinery/firealarm/directional/south,
/turf/open/floor/wood/large,
/area/station/service/barber)
"yz" = (
/obj/effect/turf_decal/siding/wood{
	dir = 4
	},
/obj/effect/mapping_helpers/broken_floor,
/turf/open/floor/wood/large,
/area/station/service/barber)
"EO" = (
/obj/effect/mapping_helpers/broken_floor,
/obj/structure/chair/sofa/bench/left{
	dir = 4
	},
/obj/effect/landmark/start/assistant,
/turf/open/floor/plating,
/area/station/service/barber)
"He" = (
/obj/machinery/door/airlock/public/glass{
	name = "Barbershop"
	},
/obj/structure/cable,
/obj/machinery/atmospherics/pipe/smart/manifold4w/supply/hidden/layer4,
/obj/machinery/atmospherics/pipe/smart/manifold4w/scrubbers/hidden/layer2,
/obj/effect/landmark/navigate_destination{
	location = "Barbershop"
	},
/turf/open/floor/iron/textured_half,
/area/station/service/barber)
"KQ" = (
/obj/effect/mapping_helpers/burnt_floor,
/obj/effect/landmark/start/barber,
/obj/machinery/light/small/directional/west,
/turf/open/floor/wood/large,
/area/station/service/barber)
"Me" = (
/obj/machinery/vending/barbervend,
/turf/open/floor/iron/dark/small,
/area/station/service/barber)
"QF" = (
/obj/structure/cable,
/obj/machinery/atmospherics/pipe/smart/manifold4w/supply/hidden/layer4,
/obj/machinery/atmospherics/pipe/smart/manifold4w/scrubbers/hidden/layer2,
/turf/open/floor/wood/large,
/area/station/service/barber)
"XS" = (
/obj/effect/landmark/start/barber,
/turf/open/floor/iron/dark/small,
/area/station/service/barber)
"XV" = (
/obj/effect/mapping_helpers/broken_floor,
/obj/structure/closet/secure_closet/barber,
/turf/open/floor/plating,
/area/station/service/barber)
"Zx" = (
/obj/structure/chair/comfy/barber_chair{
	dir = 4
	},
/turf/open/floor/iron/dark/small,
/area/station/service/barber)
"ZD" = (
/obj/machinery/camera/autoname/directional/east,
/obj/structure/table/glass,
/obj/machinery/airalarm/directional/east,
/obj/item/razor{
	pixel_x = 6;
	pixel_y = 12
	},
/obj/item/reagent_containers/spray/barbers_aid{
	pixel_x = 1;
	pixel_y = 4
	},
/obj/machinery/light/small/directional/east,
/turf/open/floor/iron/dark/small,
/area/station/service/barber)

(1,1,1) = {"
XV
KQ
EO
yf
wL
"}
(2,1,1) = {"
xN
eJ
QF
QF
He
"}
(3,1,1) = {"
na
fn
ri
yz
wI
"}
(4,1,1) = {"
lK
XS
Zx
XS
wI
"}
(5,1,1) = {"
cT
ZD
ds
Me
wL
"}
