//MAP CONVERTED BY dmm2tgm.py THIS HEADER COMMENT PREVENTS RECONVERSION, DO NOT REMOVE
"a" = (
/turf/template_noop,
/area/template_noop)
"w" = (
/obj/structure/closet/secure_closet/security/service,
/turf/open/floor/wood/parquet,
/area/station/service/bar/backroom)
"R" = (
/obj/machinery/camera/directional/north{
	c_tag = "Service - Backroom"
	},
/obj/machinery/status_display/ai/directional/north,
/obj/machinery/vending/wardrobe/bar_wardrobe,
/turf/open/floor/wood/parquet,
/area/station/service/bar/backroom)
"T" = (
/obj/structure/disposalpipe/segment{
	dir = 5
	},
/obj/effect/spawner/random/structure/crate,
/obj/effect/spawner/random/maintenance/three,
/turf/open/floor/plating,
/area/station/maintenance/starboard/fore)
"Z" = (
/turf/closed/wall,
/area/station/maintenance/starboard/fore)

(1,1,1) = {"
a
a
a
a
"}
(2,1,1) = {"
a
a
a
a
"}
(3,1,1) = {"
a
a
a
a
"}
(4,1,1) = {"
a
R
w
a
"}
(5,1,1) = {"
Z
a
a
a
"}
(6,1,1) = {"
T
a
a
a
"}
