//MAP CONVERTED BY dmm2tgm.py THIS HEADER COMMENT PREVENTS RECONVERSION, DO NOT REMOVE
"a" = (
/turf/template_noop,
/area/template_noop)
"b" = (
/obj/machinery/light/directional/east,
/obj/machinery/newscaster/directional/east,
/obj/machinery/hydroponics/constructable,
/turf/open/floor/grass,
/area/station/service/hydroponics/garden)
"u" = (
/obj/effect/turf_decal/tile/green/half/contrasted{
	dir = 8
	},
/obj/machinery/light/directional/east,
/obj/structure/table/wood,
/obj/item/storage/bag/plants,
/obj/item/plant_analyzer,
/turf/open/floor/iron/dark,
/area/station/service/hydroponics/garden)
"I" = (
/obj/machinery/camera/directional/east{
	c_tag = "Garden"
	},
/obj/machinery/status_display/ai/directional/east,
/obj/machinery/hydroponics/constructable,
/turf/open/floor/grass,
/area/station/service/hydroponics/garden)
"Q" = (
/obj/effect/turf_decal/tile/green/half/contrasted{
	dir = 8
	},
/obj/machinery/vending/hydroseeds,
/turf/open/floor/iron/dark,
/area/station/service/hydroponics/garden)
"R" = (
/obj/effect/turf_decal/tile/green/anticorner/contrasted{
	dir = 1
	},
/obj/machinery/airalarm/directional/east,
/obj/machinery/vending/hydronutrients,
/turf/open/floor/iron/dark,
/area/station/service/hydroponics/garden)
"W" = (
/obj/structure/extinguisher_cabinet/directional/east,
/obj/machinery/hydroponics/constructable,
/turf/open/floor/grass,
/area/station/service/hydroponics/garden)

(1,1,1) = {"
a
a
a
a
a
a
a
a
"}
(2,1,1) = {"
a
a
a
a
a
a
a
a
"}
(3,1,1) = {"
a
a
a
a
a
a
a
a
"}
(4,1,1) = {"
a
a
a
a
a
a
a
a
"}
(5,1,1) = {"
a
a
a
a
a
a
a
a
"}
(6,1,1) = {"
a
a
a
a
a
a
a
a
"}
(7,1,1) = {"
b
W
I
a
R
u
Q
a
"}
