//MAP CONVERTED BY dmm2tgm.py THIS HEADER COMMENT PREVENTS RECONVERSION, DO NOT REMOVE
"aM" = (
/obj/structure/cable,
/obj/machinery/atmospherics/pipe/smart/manifold4w/supply/hidden/layer4,
/obj/machinery/atmospherics/pipe/smart/manifold4w/scrubbers/hidden/layer2,
/obj/effect/decal/cleanable/blood/old,
/turf/open/floor/iron/colony/white/bolts,
/area/ruin/turretbunker)
"aO" = (
/obj/item/flatpacked_machine/station_battery,
/turf/open/floor/iron/colony,
/area/ruin/turretbunker)
"aT" = (
/obj/machinery/atmospherics/components/unary/vent_pump/high_volume/on/layer4,
/turf/open/floor/iron/colony,
/area/ruin/turretbunker)
"aZ" = (
/obj/structure/rack/shelf,
/obj/effect/spawner/random/engineering/material_cheap,
/turf/open/floor/iron/colony,
/area/ruin/turretbunker)
"br" = (
/obj/machinery/atmospherics/pipe/smart/manifold4w/scrubbers/hidden/layer2,
/turf/open/floor/iron/colony/white,
/area/ruin/turretbunker)
"bs" = (
/obj/machinery/atmospherics/pipe/smart/manifold4w/scrubbers/hidden/layer2,
/turf/open/misc/asteroid/snow/icemoon,
/area/icemoon/surface/outdoors/nospawn)
"bI" = (
/obj/structure/fence,
/turf/open/misc/asteroid/snow/icemoon,
/area/icemoon/surface/outdoors/nospawn)
"cr" = (
/obj/machinery/button/door/directional/west{
	id = "turretbunk1"
	},
/obj/machinery/microwave/frontier_printed,
/obj/structure/table/reinforced,
/turf/open/floor/iron/colony/bolts,
/area/ruin/turretbunker)
"cw" = (
/obj/structure/table/reinforced,
/obj/item/knife/butcher,
/turf/open/floor/iron/colony,
/area/ruin/turretbunker)
"da" = (
/obj/effect/decal/cleanable/blood/old,
/turf/open/floor/iron/colony/texture,
/area/ruin/turretbunker)
"dt" = (
/obj/machinery/light_switch/directional/south,
/turf/open/floor/iron/colony,
/area/ruin/turretbunker)
"eo" = (
/obj/structure/cable,
/obj/machinery/atmospherics/pipe/smart/manifold4w/scrubbers/hidden/layer2,
/obj/effect/decal/cleanable/blood/tracks,
/turf/open/misc/asteroid/snow/icemoon,
/area/icemoon/surface/outdoors/nospawn)
"ez" = (
/obj/structure/cable,
/obj/machinery/atmospherics/pipe/smart/manifold4w/scrubbers/hidden/layer2,
/obj/effect/decal/cleanable/blood/tracks,
/turf/open/floor/iron/colony/white,
/area/ruin/turretbunker)
"fa" = (
/obj/machinery/colony_recycler,
/turf/open/floor/iron/colony,
/area/ruin/turretbunker)
"fj" = (
/obj/machinery/portable_atmospherics/canister/oxygen,
/turf/open/floor/iron/colony,
/area/ruin/turretbunker)
"fC" = (
/obj/machinery/button/door/directional/north{
	id = "turretbunk2"
	},
/turf/open/floor/iron/colony,
/area/ruin/turretbunker)
"fO" = (
/obj/structure/table/reinforced,
/obj/item/kitchen/rollingpin,
/turf/open/floor/iron/colony,
/area/ruin/turretbunker)
"gy" = (
/obj/machinery/door/airlock/colony_prefab,
/turf/open/floor/iron/colony/white/texture,
/area/ruin/turretbunker)
"gQ" = (
/obj/machinery/atmospherics/components/unary/vent_scrubber/on/layer2,
/turf/open/floor/iron/colony,
/area/ruin/turretbunker)
"hf" = (
/obj/structure/window/fulltile/colony_fabricator,
/obj/machinery/door/poddoor/shutters/colony_fabricator{
	id = "turretbunk3"
	},
/turf/open/floor/iron/colony,
/area/ruin/turretbunker)
"hE" = (
/obj/machinery/power/colony_wind_turbine,
/obj/structure/cable,
/turf/open/misc/asteroid/snow/icemoon,
/area/icemoon/surface/outdoors/nospawn)
"hT" = (
/obj/structure/fence/door/opened,
/obj/effect/decal/cleanable/blood/tracks,
/turf/open/misc/asteroid/snow/icemoon,
/area/icemoon/surface/outdoors/nospawn)
"iF" = (
/obj/machinery/space_heater/wall_mounted/directional/north,
/turf/open/floor/iron/colony,
/area/ruin/turretbunker)
"iW" = (
/obj/structure/cable,
/turf/open/floor/iron/colony/white/bolts,
/area/ruin/turretbunker)
"jR" = (
/obj/structure/cable,
/obj/machinery/power/apc/auto_name/directional/east,
/obj/effect/mapping_helpers/apc/away_general_access,
/obj/effect/mapping_helpers/apc/unlocked,
/obj/effect/mapping_helpers/apc/cell_5k,
/obj/machinery/hydroponics/constructable,
/obj/effect/mapping_helpers/apc/no_charge,
/turf/open/floor/iron/colony,
/area/ruin/turretbunker)
"ka" = (
/obj/machinery/atmospherics/components/unary/vent_scrubber/on/layer2{
	dir = 8
	},
/turf/open/floor/iron/colony/texture,
/area/ruin/turretbunker)
"ku" = (
/obj/machinery/light/directional/west,
/turf/open/floor/iron/colony,
/area/ruin/turretbunker)
"lN" = (
/obj/machinery/atmospherics/components/unary/vent_pump/high_volume/on/layer4{
	dir = 8
	},
/turf/open/floor/iron/colony,
/area/ruin/turretbunker)
"mk" = (
/obj/structure/cable,
/obj/machinery/atmospherics/pipe/smart/manifold4w/supply/hidden/layer4,
/obj/machinery/atmospherics/pipe/smart/manifold4w/scrubbers/hidden/layer2,
/obj/effect/decal/cleanable/blood/tracks,
/turf/open/floor/iron/colony/white,
/area/ruin/turretbunker)
"mu" = (
/obj/structure/table/reinforced,
/obj/item/seeds/wheat,
/obj/item/seeds/tower,
/obj/item/seeds/plump,
/obj/item/seeds/corn,
/obj/item/seeds/carrot,
/obj/item/seeds/whitebeet,
/turf/open/floor/iron/colony,
/area/ruin/turretbunker)
"mF" = (
/obj/machinery/space_heater/wall_mounted/directional/east,
/obj/machinery/biogenerator,
/turf/open/floor/iron/colony,
/area/ruin/turretbunker)
"mI" = (
/obj/structure/table/reinforced,
/obj/item/xenoarch/hammer/cm1,
/turf/open/floor/iron/colony,
/area/ruin/turretbunker)
"mT" = (
/obj/structure/table/reinforced,
/obj/machinery/biogenerator/foodricator,
/turf/open/floor/iron/colony,
/area/ruin/turretbunker)
"nN" = (
/obj/structure/flora/rock/pile/icy/style_random,
/turf/open/misc/asteroid/snow/icemoon,
/area/icemoon/surface/outdoors/nospawn)
"on" = (
/obj/machinery/light/directional/north,
/turf/open/floor/iron/colony,
/area/ruin/turretbunker)
"pj" = (
/turf/open/misc/asteroid/snow/icemoon,
/area/icemoon/surface/outdoors/nospawn)
"qh" = (
/obj/item/hatchet/wooden,
/obj/item/stack/cable_coil/five,
/turf/open/misc/asteroid/snow/icemoon,
/area/icemoon/surface/outdoors/nospawn)
"qA" = (
/obj/machinery/door/airlock/colony_prefab,
/obj/structure/cable,
/obj/machinery/atmospherics/pipe/smart/manifold4w/scrubbers/hidden/layer2,
/obj/structure/barricade/wooden/crude/snow,
/obj/effect/decal/cleanable/blood/tracks,
/turf/open/floor/iron/colony/white/texture,
/area/ruin/turretbunker)
"rA" = (
/obj/structure/fence{
	dir = 4
	},
/turf/open/misc/asteroid/snow/icemoon,
/area/icemoon/surface/outdoors/nospawn)
"rC" = (
/obj/structure/cable,
/obj/machinery/atmospherics/pipe/smart/manifold4w/supply/hidden/layer4,
/obj/machinery/atmospherics/pipe/smart/manifold4w/scrubbers/hidden/layer2,
/obj/effect/mob_spawn/corpse/human/minesite,
/turf/open/floor/iron/colony/white,
/area/ruin/turretbunker)
"sa" = (
/obj/machinery/atmospherics/pipe/smart/manifold4w/supply/hidden/layer4,
/turf/open/floor/iron/colony/texture,
/area/ruin/turretbunker)
"sn" = (
/obj/effect/spawner/random/throwturret,
/turf/open/floor/iron/colony/bolts,
/area/ruin/turretbunker)
"sX" = (
/obj/structure/fence/corner{
	dir = 6
	},
/turf/open/misc/asteroid/snow/icemoon,
/area/icemoon/surface/outdoors/nospawn)
"tn" = (
/obj/structure/cable,
/obj/machinery/atmospherics/pipe/smart/manifold4w/supply/hidden/layer4,
/obj/machinery/atmospherics/pipe/smart/manifold4w/scrubbers/hidden/layer2,
/turf/open/floor/iron/colony/white,
/area/ruin/turretbunker)
"tt" = (
/obj/machinery/biogenerator/organic_printer,
/turf/open/floor/iron/colony/bolts,
/area/ruin/turretbunker)
"wy" = (
/obj/structure/table/reinforced,
/obj/item/cultivator,
/obj/item/shovel/spade,
/obj/machinery/light/dim/directional/south,
/obj/machinery/airalarm/directional/south,
/obj/effect/mapping_helpers/airalarm/all_access,
/turf/open/floor/iron/colony,
/area/ruin/turretbunker)
"wZ" = (
/obj/structure/rack/shelf,
/obj/effect/spawner/random/engineering/material,
/obj/machinery/light/directional/east,
/turf/open/floor/iron/colony,
/area/ruin/turretbunker)
"xp" = (
/obj/item/stack/cable_coil/thirty,
/turf/open/floor/iron/colony,
/area/ruin/turretbunker)
"yf" = (
/obj/machinery/oven/range_frontier,
/turf/open/floor/iron/colony,
/area/ruin/turretbunker)
"yE" = (
/obj/structure/table/reinforced,
/obj/item/construction/plumbing/mining,
/turf/open/floor/iron/colony/bolts,
/area/ruin/turretbunker)
"zb" = (
/obj/structure/table/reinforced,
/obj/item/storage/bag/plants/portaseeder,
/turf/open/floor/iron/colony,
/area/ruin/turretbunker)
"As" = (
/obj/structure/window/fulltile/colony_fabricator,
/obj/machinery/door/poddoor/shutters/colony_fabricator{
	id = "turretbunk1"
	},
/turf/open/floor/iron/colony,
/area/ruin/turretbunker)
"AJ" = (
/obj/structure/table/reinforced,
/obj/item/xenoarch/hammer/cm10,
/obj/item/storage/bag/xenoarch,
/turf/open/floor/iron/colony/bolts,
/area/ruin/turretbunker)
"AP" = (
/obj/machinery/light_switch/directional/north,
/turf/open/floor/iron/colony,
/area/ruin/turretbunker)
"Bk" = (
/obj/structure/table/reinforced,
/obj/item/t_scanner/adv_mining_scanner/lesser,
/turf/open/floor/iron/colony/bolts,
/area/ruin/turretbunker)
"Bt" = (
/obj/machinery/airalarm/directional/west,
/obj/effect/mapping_helpers/airalarm/all_access,
/turf/open/floor/iron/colony/bolts,
/area/ruin/turretbunker)
"BQ" = (
/obj/machinery/griddle/frontier_tabletop,
/turf/open/floor/iron/colony,
/area/ruin/turretbunker)
"BX" = (
/obj/machinery/light/directional/south,
/turf/open/floor/iron/colony,
/area/ruin/turretbunker)
"Cz" = (
/obj/effect/spawner/random/magturret,
/turf/open/floor/iron/colony,
/area/ruin/turretbunker)
"CG" = (
/obj/machinery/space_heater/wall_mounted/directional/west,
/turf/open/floor/iron/colony,
/area/ruin/turretbunker)
"CZ" = (
/obj/machinery/atmospherics/components/unary/vent_scrubber/on/layer2{
	dir = 4
	},
/turf/open/floor/iron/colony,
/area/ruin/turretbunker)
"Dc" = (
/obj/structure/window/fulltile/colony_fabricator,
/obj/machinery/door/poddoor/shutters/colony_fabricator{
	id = "turretbunk3"
	},
/obj/effect/decal/cleanable/blood/splatter/over_window,
/turf/open/floor/iron/colony,
/area/ruin/turretbunker)
"Di" = (
/obj/structure/table/reinforced,
/obj/item/xenoarch/tape_measure,
/obj/machinery/light/directional/east,
/obj/effect/decal/cleanable/blood/splatter,
/turf/open/floor/iron/colony,
/area/ruin/turretbunker)
"DH" = (
/obj/machinery/atmospherics/components/unary/vent_pump/high_volume/on/layer4{
	dir = 4
	},
/turf/open/floor/iron/colony/texture,
/area/ruin/turretbunker)
"DK" = (
/obj/machinery/recharge_station,
/turf/open/floor/iron/colony,
/area/ruin/turretbunker)
"Ey" = (
/obj/structure/cable,
/obj/machinery/atmospherics/pipe/smart/manifold4w/supply/hidden/layer4,
/obj/machinery/atmospherics/pipe/smart/manifold4w/scrubbers/hidden/layer2,
/obj/machinery/porta_turret/syndicate/toolbox/mag_fed/colonist/malf,
/turf/open/floor/iron/colony/white,
/area/ruin/turretbunker)
"Gn" = (
/obj/structure/cable,
/turf/open/floor/iron/colony/texture,
/area/ruin/turretbunker)
"Go" = (
/obj/structure/table/reinforced,
/obj/item/target_designator/sniper,
/turf/open/floor/iron/colony/bolts,
/area/ruin/turretbunker)
"GX" = (
/turf/open/floor/iron/colony/white,
/area/ruin/turretbunker)
"Ij" = (
/obj/machinery/atmospherics/components/binary/valve/on/layer4,
/turf/open/floor/iron/colony,
/area/ruin/turretbunker)
"Jd" = (
/obj/machinery/suit_storage_unit/open,
/turf/open/floor/iron/colony,
/area/ruin/turretbunker)
"Lb" = (
/obj/machinery/cell_charger_multi/wall_mounted/directional/south,
/turf/open/floor/iron/colony/bolts,
/area/ruin/turretbunker)
"LR" = (
/obj/machinery/hydroponics/constructable,
/turf/open/floor/iron/colony,
/area/ruin/turretbunker)
"MH" = (
/obj/structure/table/reinforced,
/obj/item/storage/bag/ore,
/obj/machinery/light/directional/west,
/turf/open/floor/iron/colony,
/area/ruin/turretbunker)
"NF" = (
/obj/structure/flora/tree/pine/style_random,
/turf/open/misc/asteroid/snow/icemoon,
/area/icemoon/surface/outdoors/nospawn)
"NP" = (
/turf/open/floor/iron/colony,
/area/ruin/turretbunker)
"NQ" = (
/obj/machinery/atmospherics/components/unary/vent_pump/high_volume/on/layer4{
	dir = 4
	},
/obj/effect/decal/cleanable/blood/old,
/turf/open/floor/iron/colony/texture,
/area/ruin/turretbunker)
"Oj" = (
/turf/open/floor/iron/colony/texture,
/area/ruin/turretbunker)
"OF" = (
/obj/structure/cable,
/obj/machinery/atmospherics/pipe/smart/manifold4w/supply/hidden/layer4,
/obj/machinery/atmospherics/pipe/smart/manifold4w/scrubbers/hidden/layer2,
/turf/open/floor/iron/colony/white/bolts,
/area/ruin/turretbunker)
"QG" = (
/obj/machinery/atmospherics/pipe/smart/manifold4w/supply/hidden/layer4,
/turf/open/floor/iron/colony,
/area/ruin/turretbunker)
"RW" = (
/obj/machinery/light_switch/directional/north,
/obj/effect/decal/cleanable/blood/splatter,
/turf/open/floor/iron/colony,
/area/ruin/turretbunker)
"Td" = (
/obj/machinery/atmospherics/components/unary/passive_vent/layer2{
	dir = 4
	},
/turf/open/misc/asteroid/snow/icemoon,
/area/icemoon/surface/outdoors/nospawn)
"Tx" = (
/obj/machinery/atmospherics/pipe/smart/manifold4w/supply/hidden/layer4,
/obj/machinery/atmospherics/components/tank/air,
/obj/machinery/light/dim/directional/south,
/turf/open/floor/iron/colony/bolts,
/area/ruin/turretbunker)
"TE" = (
/obj/structure/window/fulltile/colony_fabricator,
/obj/machinery/door/poddoor/shutters/colony_fabricator{
	id = "turretbunk2"
	},
/turf/open/floor/iron/colony,
/area/ruin/turretbunker)
"TK" = (
/turf/closed/wall/prefab_plastic,
/area/ruin/turretbunker)
"UV" = (
/obj/structure/table/reinforced,
/obj/item/xenoarch/brush,
/turf/open/floor/iron/colony/bolts,
/area/ruin/turretbunker)
"VR" = (
/obj/effect/decal/cleanable/blood/tracks,
/turf/open/misc/asteroid/snow/icemoon,
/area/icemoon/surface/outdoors/nospawn)
"Wx" = (
/obj/effect/mob_spawn/corpse/human/minesite,
/obj/effect/decal/cleanable/blood/gibs/old,
/turf/open/floor/iron/colony/texture,
/area/ruin/turretbunker)
"Yn" = (
/obj/machinery/door/airlock/colony_prefab,
/obj/structure/cable,
/obj/machinery/atmospherics/pipe/smart/manifold4w/supply/hidden/layer4,
/obj/machinery/atmospherics/pipe/smart/manifold4w/scrubbers/hidden/layer2,
/turf/open/floor/iron/colony/white/texture,
/area/ruin/turretbunker)
"YB" = (
/obj/machinery/button/door/directional/east{
	id = "turretbunk3"
	},
/obj/machinery/light/dim/directional/north,
/obj/machinery/airalarm/directional/north,
/obj/effect/mapping_helpers/airalarm/all_access,
/turf/open/floor/iron/colony/bolts,
/area/ruin/turretbunker)
"Zu" = (
/obj/structure/table/reinforced,
/obj/item/pickaxe/mini,
/turf/open/floor/iron/colony,
/area/ruin/turretbunker)

(1,1,1) = {"
pj
pj
pj
NF
pj
pj
pj
pj
nN
pj
pj
pj
pj
pj
NF
nN
"}
(2,1,1) = {"
pj
TK
TK
TK
TK
TK
TK
TK
TK
TK
As
As
As
TK
TK
pj
"}
(3,1,1) = {"
pj
TK
Bk
MH
yE
TK
Bt
aO
xp
ku
yf
cw
fO
cr
TK
pj
"}
(4,1,1) = {"
nN
TE
Zu
Cz
CZ
TK
RW
NQ
Wx
Oj
Oj
DH
Oj
mT
As
pj
"}
(5,1,1) = {"
pj
TE
aT
OF
tn
Yn
tn
tn
tn
tn
Ey
tn
iW
BQ
As
pj
"}
(6,1,1) = {"
pj
TE
NP
tn
GX
gy
GX
br
GX
GX
GX
br
iW
NP
As
pj
"}
(7,1,1) = {"
pj
TK
fC
tn
dt
TK
on
ka
Oj
Oj
Oj
ka
Gn
BX
TK
pj
"}
(8,1,1) = {"
pj
TK
NP
tn
zb
TK
Go
fa
aZ
wZ
mF
LR
jR
tt
TK
pj
"}
(9,1,1) = {"
pj
TK
NP
tn
wy
TK
TK
TK
TK
TK
TK
TK
TK
TK
TK
pj
"}
(10,1,1) = {"
NF
TK
iF
tn
mu
TK
sn
NP
CG
DK
Lb
TK
Td
pj
rA
NF
"}
(11,1,1) = {"
pj
TK
NP
rC
dt
TK
NP
DH
Oj
Oj
dt
TK
bs
pj
rA
pj
"}
(12,1,1) = {"
pj
TK
gQ
aM
tn
Yn
tn
tn
mk
mk
ez
qA
eo
VR
hT
pj
"}
(13,1,1) = {"
pj
TK
mI
NP
lN
TK
AP
da
sa
ka
Jd
TK
qh
pj
rA
pj
"}
(14,1,1) = {"
pj
TK
AJ
Di
UV
TK
YB
fj
QG
Ij
Tx
TK
hE
hE
rA
pj
"}
(15,1,1) = {"
pj
TK
TK
TK
TK
TK
TK
hf
Dc
hf
TK
TK
bI
bI
sX
pj
"}
(16,1,1) = {"
pj
pj
pj
pj
pj
pj
pj
NF
pj
pj
pj
pj
pj
nN
pj
pj
"}
