//MAP CONVERTED BY dmm2tgm.py THIS HEADER COMMENT PREVENTS RECONVERSION, DO NOT REMOVE
"a" = (
/obj/structure/lattice,
/turf/open/misc/asteroid/snow/icemoon,
/area/icemoon/surface/outdoors/nospawn)
"f" = (
/obj/docking_port/stationary{
	dir = 2;
	dwidth = 8;
	height = 24;
	name = "NT Nav. beacon";
	shuttle_id = "nt_nav";
	width = 35
	},
/turf/open/misc/asteroid/snow/icemoon,
/area/icemoon/surface/outdoors/nospawn)
"h" = (
/obj/structure/flora/tree/pine/style_random,
/turf/open/misc/asteroid/snow/icemoon,
/area/icemoon/surface/outdoors/nospawn)
"k" = (
/obj/item/gps/computer/beacon{
	pixel_y = 27;
	pixel_x = 8;
	gpstag = "NT-STATION"
	},
/obj/machinery/spaceship_navigation_beacon/nt{
	pixel_x = -7;
	pixel_y = 23
	},
/obj/structure/fluff{
	icon = 'icons/mob/simple/hivebot.dmi';
	icon_state = "def_radar-off";
	name = "radio dish component";
	desc = "Remarkable Nanotrasen technology. This does... something to make the radio dish work."
	},
/obj/structure/fluff/sat_dish{
	pixel_y = 6;
	pixel_x = -11
	},
/obj/structure/fluff/sat_dish{
	dir = 1;
	pixel_x = -11;
	pixel_y = -14
	},
/obj/structure/fluff/sat_dish{
	dir = 4;
	pixel_y = 1;
	pixel_x = 17
	},
/obj/machinery/power/rtg/portable{
	pixel_y = -12;
	pixel_x = 5
	},
/turf/open/misc/sandy_dirt/icemoon,
/area/icemoon/surface/outdoors/nospawn)
"n" = (
/turf/open/misc/asteroid/snow/icemoon,
/area/icemoon/surface/outdoors/nospawn)
"p" = (
/obj/structure/flora/grass/both/style_random,
/turf/open/misc/asteroid/snow/icemoon,
/area/icemoon/surface/outdoors/nospawn)
"u" = (
/obj/structure/lattice/catwalk,
/obj/structure/marker_beacon/cerulean,
/turf/open/misc/sandy_dirt/icemoon,
/area/icemoon/surface/outdoors/nospawn)
"K" = (
/obj/structure/statue/snow/snowman,
/turf/open/misc/asteroid/snow/icemoon,
/area/icemoon/surface/outdoors/nospawn)
"Z" = (
/obj/structure/lattice/catwalk,
/obj/structure/marker_beacon/indigo,
/turf/open/misc/sandy_dirt/icemoon,
/area/icemoon/surface/outdoors/nospawn)

(1,1,1) = {"
n
n
n
n
n
n
n
n
n
n
n
n
n
n
"}
(2,1,1) = {"
n
n
n
n
n
n
n
n
n
n
n
n
n
n
"}
(3,1,1) = {"
n
n
n
n
n
n
n
n
n
n
n
n
p
n
"}
(4,1,1) = {"
n
n
n
n
n
n
n
n
n
n
n
n
n
n
"}
(5,1,1) = {"
n
n
n
p
n
n
n
n
n
n
n
n
n
n
"}
(6,1,1) = {"
n
n
n
n
n
n
n
n
n
n
n
n
n
n
"}
(7,1,1) = {"
n
n
n
n
n
n
n
n
n
n
n
n
n
n
"}
(8,1,1) = {"
p
n
n
n
n
n
n
n
n
p
n
n
n
n
"}
(9,1,1) = {"
n
n
a
Z
a
n
n
n
n
n
n
n
n
n
"}
(10,1,1) = {"
n
n
u
k
u
f
n
n
n
n
n
n
n
n
"}
(11,1,1) = {"
n
n
a
Z
a
n
n
n
n
n
n
n
n
n
"}
(12,1,1) = {"
n
n
n
n
K
n
n
n
n
n
n
n
n
n
"}
(13,1,1) = {"
n
n
n
n
n
n
n
n
n
n
n
n
n
n
"}
(14,1,1) = {"
n
n
n
n
n
n
n
n
n
n
n
n
n
n
"}
(15,1,1) = {"
n
n
n
n
n
n
n
n
n
n
n
n
p
n
"}
(16,1,1) = {"
n
n
n
n
n
p
n
n
n
n
n
n
n
n
"}
(17,1,1) = {"
n
h
n
n
n
n
n
n
n
n
n
n
n
n
"}
(18,1,1) = {"
n
n
n
n
n
n
n
n
n
n
n
n
n
n
"}
