//MAP CONVERTED BY dmm2tgm.py THIS HEADER COMMENT PREVENTS RECONVERSION, DO NOT REMOVE
"a" = (
/turf/open/misc/asteroid/snow/icemoon,
/area/icemoon/surface/outdoors/nospawn)
"e" = (
/mob/living/basic/mining/wolf,
/turf/open/misc/asteroid/snow/icemoon,
/area/icemoon/surface/outdoors/nospawn)
"i" = (
/obj/structure/table/rolling,
/obj/item/flatpacked_machine/boulder_collector,
/turf/open/misc/asteroid/snow/icemoon,
/area/icemoon/surface/outdoors/nospawn)
"k" = (
/obj/effect/turf_decal/stripes/white/line{
	dir = 4
	},
/turf/open/misc/asteroid/snow/icemoon,
/area/icemoon/surface/outdoors/nospawn)
"q" = (
/obj/effect/turf_decal/stripes/white/line{
	dir = 5
	},
/mob/living/basic/mining/wolf,
/turf/open/misc/asteroid/snow/icemoon,
/area/icemoon/surface/outdoors/nospawn)
"t" = (
/obj/effect/turf_decal/stripes/white/line{
	dir = 9
	},
/turf/open/misc/asteroid/snow/icemoon,
/area/icemoon/surface/outdoors/nospawn)
"y" = (
/obj/effect/turf_decal/stripes/white/line{
	dir = 1
	},
/turf/open/misc/asteroid/snow/icemoon,
/area/icemoon/surface/outdoors/nospawn)
"G" = (
/obj/effect/turf_decal/stripes/white/line,
/turf/open/misc/asteroid/snow/icemoon,
/area/icemoon/surface/outdoors/nospawn)
"I" = (
/obj/effect/mob_spawn/corpse/human/miner/explorer,
/turf/open/misc/asteroid/snow/icemoon,
/area/icemoon/surface/outdoors/nospawn)
"K" = (
/obj/effect/turf_decal/stripes/white/line{
	dir = 10
	},
/turf/open/misc/asteroid/snow/icemoon,
/area/icemoon/surface/outdoors/nospawn)
"M" = (
/obj/effect/turf_decal/stripes/white/line{
	dir = 6
	},
/turf/open/misc/asteroid/snow/icemoon,
/area/icemoon/surface/outdoors/nospawn)
"N" = (
/obj/effect/turf_decal/stripes/white/line{
	dir = 9
	},
/mob/living/basic/mining/wolf,
/turf/open/misc/asteroid/snow/icemoon,
/area/icemoon/surface/outdoors/nospawn)
"Q" = (
/obj/effect/turf_decal/stripes/white/line{
	dir = 8
	},
/turf/open/misc/asteroid/snow/icemoon,
/area/icemoon/surface/outdoors/nospawn)
"S" = (
/obj/structure/ore_vent/ghost_mining/snowland,
/turf/open/misc/asteroid/snow/icemoon,
/area/icemoon/surface/outdoors/nospawn)
"Y" = (
/obj/effect/turf_decal/stripes/white/line{
	dir = 5
	},
/turf/open/misc/asteroid/snow/icemoon,
/area/icemoon/surface/outdoors/nospawn)

(1,1,1) = {"
M
Q
Q
Q
Q
Q
Q
Q
Y
"}
(2,1,1) = {"
y
a
i
a
a
a
a
a
G
"}
(3,1,1) = {"
y
a
M
Q
Q
Q
q
a
G
"}
(4,1,1) = {"
y
a
y
a
a
a
G
a
G
"}
(5,1,1) = {"
y
a
y
a
S
a
G
a
G
"}
(6,1,1) = {"
y
a
y
e
a
I
G
a
G
"}
(7,1,1) = {"
y
a
K
k
k
k
N
a
G
"}
(8,1,1) = {"
y
a
a
a
a
a
a
a
G
"}
(9,1,1) = {"
K
k
k
k
k
k
k
k
t
"}
