//MAP CONVERTED BY dmm2tgm.py THIS HEADER COMMENT PREVENTS RECONVERSION, DO NOT REMOVE
"au" = (
/obj/structure/flora/bush/fullgrass/style_random,
/obj/structure/flora/bush/flowers_br/style_random,
/obj/effect/decal/cleanable/dirt/dust,
/obj/effect/decal/cleanable/dirt/dust,
/turf/open/floor/grass{
	initial_gas_mix = "ICEMOON_ATMOS"
	},
/area/ruin/unpowered/frozenwake)
"ay" = (
/obj/structure/statue/hearthkin/frozenwake/puzzle/betrayer,
/obj/effect/decal/cleanable/dirt/dust,
/turf/open/floor/mineral/gold/icemoon,
/area/ruin/unpowered/frozenwake)
"er" = (
/obj/effect/decal/cleanable/dirt/dust,
/obj/structure/deployable_barricade/wooden,
/turf/open/floor/stone/icemoon,
/area/ruin/unpowered/frozenwake)
"eX" = (
/turf/closed/mineral/snowmountain/icemoon,
/area/ruin/unpowered/frozenwake)
"fo" = (
/obj/effect/turf_decal/weather/snow,
/obj/structure/flora/bush/fullgrass/style_random,
/turf/open/floor/grass{
	initial_gas_mix = "ICEMOON_ATMOS"
	},
/area/ruin/unpowered/frozenwake)
"gb" = (
/obj/structure/table/wood/fancy/orange,
/obj/item/coin/gold,
/obj/effect/decal/cleanable/dirt/dust,
/turf/open/floor/stone/icemoon,
/area/ruin/unpowered/frozenwake)
"gp" = (
/obj/structure/statue/hearthkin/frozenwake,
/obj/effect/decal/cleanable/dirt/dust,
/turf/open/floor/mineral/gold/icemoon,
/area/ruin/unpowered/frozenwake)
"gz" = (
/obj/structure/statue/hearthkin/frozenwake/stele/watch,
/obj/effect/decal/cleanable/dirt/dust,
/turf/open/floor/mineral/gold/icemoon,
/area/ruin/unpowered/frozenwake)
"gG" = (
/obj/structure/flora/bush/flowers_br/style_random,
/obj/structure/flora/bush/fullgrass/style_random,
/obj/effect/decal/cleanable/dirt/dust,
/turf/open/floor/grass{
	initial_gas_mix = "ICEMOON_ATMOS"
	},
/area/ruin/unpowered/frozenwake)
"hp" = (
/obj/structure/flora/bush/fullgrass/style_random,
/obj/structure/flora/bush/flowers_pp/style_random,
/obj/effect/decal/cleanable/dirt/dust,
/turf/open/floor/grass{
	initial_gas_mix = "ICEMOON_ATMOS"
	},
/area/ruin/unpowered/frozenwake)
"hH" = (
/obj/structure/statue/bone/skull,
/turf/open/misc/asteroid/snow/icemoon,
/area/ruin/unpowered/frozenwake)
"hQ" = (
/obj/effect/decal/cleanable/dirt/dust,
/turf/open/floor/stone/icemoon,
/area/ruin/unpowered/frozenwake)
"hX" = (
/obj/structure/wall_torch/directional/east,
/obj/effect/decal/cleanable/dirt/dust,
/turf/open/floor/stone/icemoon,
/area/ruin/unpowered/frozenwake)
"hY" = (
/obj/effect/decal/cleanable/rubble,
/obj/item/stack/stone,
/obj/effect/decal/cleanable/dirt/dust,
/turf/open/floor/mineral/gold/icemoon,
/area/ruin/unpowered/frozenwake)
"mb" = (
/obj/effect/decal/cleanable/dirt/dust,
/turf/open/misc/ice/icemoon,
/area/ruin/unpowered/frozenwake)
"my" = (
/turf/template_noop,
/area/template_noop)
"np" = (
/mob/living/basic/ghost/swarm/frozenwake,
/obj/effect/decal/cleanable/dirt/dust,
/turf/open/floor/stone/icemoon,
/area/ruin/unpowered/frozenwake)
"nx" = (
/obj/structure/wall_torch/spawns_lit/directional/west,
/obj/effect/decal/cleanable/dirt/dust,
/turf/open/floor/stone/icemoon,
/area/ruin/unpowered/frozenwake)
"oX" = (
/turf/open/misc/ice/icemoon,
/area/ruin/unpowered/frozenwake)
"ps" = (
/obj/structure/mineral_door/wood/large_gate,
/turf/open/floor/stone/icemoon,
/area/ruin/unpowered/frozenwake)
"pw" = (
/obj/structure/statue/hearthkin/frozenwake/stele/mourning,
/obj/effect/decal/cleanable/dirt/dust,
/turf/open/floor/mineral/gold/icemoon,
/area/ruin/unpowered/frozenwake)
"pS" = (
/obj/structure/wall_torch/spawns_lit/directional/west,
/obj/effect/decal/cleanable/dirt/dust,
/turf/open/misc/dirt/icemoon,
/area/ruin/unpowered/frozenwake)
"qa" = (
/obj/structure/bonfire/dense/prelit,
/obj/effect/decal/cleanable/dirt/dust,
/turf/open/floor/stone/icemoon,
/area/ruin/unpowered/frozenwake)
"qK" = (
/obj/structure/window/green_glass_pane,
/turf/open/floor/stone/icemoon,
/area/ruin/unpowered/frozenwake)
"rW" = (
/obj/structure/statue/hearthkin/frozenwake/puzzle/avenger,
/obj/effect/decal/cleanable/dirt/dust,
/turf/open/floor/mineral/gold/icemoon,
/area/ruin/unpowered/frozenwake)
"sZ" = (
/obj/structure/statue/hearthkin/frozenwake/stele/weeping_spear,
/obj/effect/decal/cleanable/dirt/dust,
/obj/effect/decal/cleanable/dirt/dust,
/turf/open/floor/mineral/gold/icemoon,
/area/ruin/unpowered/frozenwake)
"tp" = (
/obj/structure/table/wood/fancy/orange,
/obj/item/coin/runite,
/obj/effect/decal/cleanable/dirt/dust,
/turf/open/floor/stone/icemoon,
/area/ruin/unpowered/frozenwake)
"vc" = (
/mob/living/basic/ghost/swarm/frozenwake/unproven,
/obj/effect/decal/cleanable/dirt/dust,
/turf/open/floor/stone/icemoon,
/area/ruin/unpowered/frozenwake)
"xh" = (
/obj/structure/mineral_door/wood/large_gate{
	dir = 1
	},
/turf/open/floor/stone/icemoon,
/area/ruin/unpowered/frozenwake)
"xC" = (
/obj/effect/decal/cleanable/dirt/dust,
/obj/effect/decal/remains/human,
/turf/open/misc/dirt/icemoon,
/area/ruin/unpowered/frozenwake)
"xJ" = (
/obj/structure/statue/hearthkin/frozenwake/puzzle/fall,
/obj/effect/decal/cleanable/dirt/dust,
/turf/open/floor/mineral/gold/icemoon,
/area/ruin/unpowered/frozenwake)
"xX" = (
/obj/structure/wall_torch/directional/east,
/obj/effect/decal/cleanable/dirt/dust,
/turf/open/misc/dirt/icemoon,
/area/ruin/unpowered/frozenwake)
"yR" = (
/obj/effect/turf_decal/weather/snow,
/obj/effect/decal/remains/human,
/turf/open/floor/stone/icemoon,
/area/ruin/unpowered/frozenwake)
"Cv" = (
/obj/effect/decal/cleanable/dirt/dust,
/obj/effect/decal/remains/human,
/turf/open/floor/stone/icemoon,
/area/ruin/unpowered/frozenwake)
"CK" = (
/obj/structure/statue/hearthkin/frozenwake/puzzle/watcher,
/obj/effect/decal/cleanable/dirt/dust,
/turf/open/floor/mineral/gold/icemoon,
/area/ruin/unpowered/frozenwake)
"Dm" = (
/obj/structure/flora/bush/fullgrass/style_random,
/obj/effect/decal/cleanable/dirt/dust,
/obj/effect/decal/cleanable/dirt/dust,
/turf/open/floor/grass{
	initial_gas_mix = "ICEMOON_ATMOS"
	},
/area/ruin/unpowered/frozenwake)
"DM" = (
/obj/structure/mineral_door/wood/large_gate,
/obj/effect/decal/cleanable/dirt/dust,
/turf/open/floor/stone/icemoon,
/area/ruin/unpowered/frozenwake)
"FO" = (
/obj/effect/decal/cleanable/glass,
/turf/open/misc/ice/icemoon,
/area/ruin/unpowered/frozenwake)
"HJ" = (
/obj/structure/table/wood/fancy/orange,
/obj/item/paper/crumpled/bloody/fluff/stations/lavaland/frozenwake,
/obj/effect/decal/cleanable/dirt/dust,
/turf/open/floor/stone/icemoon,
/area/ruin/unpowered/frozenwake)
"Je" = (
/obj/structure/flora/bush/fullgrass/style_random,
/obj/structure/flora/bush/flowers_br/style_random,
/obj/effect/decal/cleanable/dirt/dust,
/turf/open/floor/grass{
	initial_gas_mix = "ICEMOON_ATMOS"
	},
/area/ruin/unpowered/frozenwake)
"JR" = (
/obj/structure/barricade/wooden/crude/snow,
/obj/structure/barricade/wooden/snowed,
/obj/effect/turf_decal/weather/snow,
/turf/open/floor/stone/icemoon,
/area/ruin/unpowered/frozenwake)
"JY" = (
/obj/structure/statue/hearthkin/frozenwake/puzzle/dreamer,
/obj/effect/decal/cleanable/dirt/dust,
/turf/open/floor/mineral/gold/icemoon,
/area/ruin/unpowered/frozenwake)
"Kg" = (
/obj/effect/decal/cleanable/dirt/dust,
/obj/structure/deployable_barricade/wooden,
/turf/open/misc/dirt/icemoon,
/area/ruin/unpowered/frozenwake)
"KP" = (
/obj/effect/decal/cleanable/dirt/dust,
/turf/open/misc/dirt/icemoon,
/area/ruin/unpowered/frozenwake)
"LC" = (
/obj/structure/statue/hearthkin/frozenwake/stele/oath,
/obj/effect/decal/cleanable/dirt/dust,
/turf/open/floor/mineral/gold/icemoon,
/area/ruin/unpowered/frozenwake)
"LN" = (
/obj/structure/flora/bush/fullgrass/style_random,
/obj/effect/decal/cleanable/dirt/dust,
/turf/open/floor/grass{
	initial_gas_mix = "ICEMOON_ATMOS"
	},
/area/ruin/unpowered/frozenwake)
"MN" = (
/obj/structure/flora/bush/fullgrass/style_random,
/obj/effect/decal/cleanable/dirt/dust,
/turf/open/misc/dirt/icemoon,
/area/ruin/unpowered/frozenwake)
"MX" = (
/obj/structure/statue/hearthkin/frozenwake/stele/dream,
/obj/effect/decal/cleanable/dirt/dust,
/turf/open/floor/mineral/gold/icemoon,
/area/ruin/unpowered/frozenwake)
"Nr" = (
/obj/item/stack/stone,
/obj/effect/decal/cleanable/rubble,
/obj/effect/decal/cleanable/dirt/dust,
/turf/open/floor/mineral/gold/icemoon,
/area/ruin/unpowered/frozenwake)
"Nt" = (
/obj/structure/flora/tree/jungle/small/style_6,
/obj/effect/decal/cleanable/dirt/dust,
/turf/open/floor/grass{
	initial_gas_mix = "ICEMOON_ATMOS"
	},
/area/ruin/unpowered/frozenwake)
"Ov" = (
/obj/effect/decal/cleanable/rubble,
/turf/open/misc/ice/icemoon,
/area/ruin/unpowered/frozenwake)
"OE" = (
/obj/structure/statue/hearthkin/frozenwake/puzzle/circle,
/obj/effect/decal/cleanable/dirt/dust,
/turf/open/floor/mineral/gold/icemoon,
/area/ruin/unpowered/frozenwake)
"QG" = (
/turf/closed/wall/mineral/stone,
/area/ruin/unpowered/frozenwake)
"Se" = (
/obj/effect/turf_decal/weather/snow,
/turf/open/floor/stone/icemoon,
/area/ruin/unpowered/frozenwake)
"Sz" = (
/turf/open/misc/asteroid/snow/icemoon,
/area/ruin/unpowered/frozenwake)
"SV" = (
/obj/effect/decal/cleanable/dirt/dust,
/obj/effect/decal/remains/human,
/turf/open/misc/ice/icemoon,
/area/ruin/unpowered/frozenwake)
"Uf" = (
/mob/living/basic/ghost/swarm/frozenwake,
/turf/open/misc/ice/icemoon,
/area/ruin/unpowered/frozenwake)
"Xv" = (
/obj/structure/flora/bush/fullgrass/style_random,
/obj/structure/flora/tree/jungle/small/style_6,
/obj/effect/decal/cleanable/dirt/dust,
/turf/open/floor/grass{
	initial_gas_mix = "ICEMOON_ATMOS"
	},
/area/ruin/unpowered/frozenwake)
"Yy" = (
/obj/structure/ice_stasis/frozenwake,
/obj/effect/decal/cleanable/dirt/dust,
/turf/open/floor/stone/icemoon,
/area/ruin/unpowered/frozenwake)
"ZK" = (
/obj/structure/table/wood/fancy/orange,
/obj/item/chisel,
/obj/effect/decal/cleanable/dirt/dust,
/turf/open/floor/stone/icemoon,
/area/ruin/unpowered/frozenwake)

(1,1,1) = {"
my
my
my
my
my
my
my
eX
eX
eX
eX
eX
eX
eX
eX
my
my
my
my
my
my
my
my
my
my
my
my
my
my
my
my
my
my
my
my
my
my
my
my
my
my
my
my
my
my
my
my
my
my
my
my
my
my
my
my
"}
(2,1,1) = {"
my
my
my
my
my
eX
eX
eX
eX
eX
eX
eX
eX
eX
eX
eX
my
my
my
my
my
my
my
my
my
my
my
my
my
my
my
my
my
my
my
my
my
my
my
my
my
my
my
my
my
my
my
my
my
my
my
my
my
my
my
"}
(3,1,1) = {"
my
my
my
my
eX
eX
eX
Sz
Sz
Sz
Sz
Sz
Sz
Sz
Sz
eX
eX
my
my
my
eX
eX
eX
eX
eX
eX
eX
eX
eX
my
my
my
my
my
my
my
my
my
my
my
my
my
my
my
my
my
my
my
my
my
my
my
my
my
my
"}
(4,1,1) = {"
my
my
my
eX
eX
eX
Sz
Sz
QG
QG
qK
qK
QG
QG
Sz
Sz
eX
eX
eX
eX
eX
eX
eX
eX
eX
eX
eX
eX
eX
eX
eX
my
my
my
my
my
my
my
my
my
my
my
my
my
my
my
my
my
my
my
my
my
my
my
my
"}
(5,1,1) = {"
my
my
my
eX
eX
Sz
Sz
QG
QG
nx
hQ
hQ
nx
QG
QG
Sz
Sz
eX
eX
eX
Sz
Sz
Sz
Sz
Sz
Sz
Sz
Sz
Sz
eX
eX
eX
my
my
my
my
my
my
my
my
my
my
my
my
my
my
my
my
my
my
my
my
my
my
my
"}
(6,1,1) = {"
my
my
my
eX
eX
Sz
QG
QG
hQ
hQ
hQ
hQ
hQ
hQ
QG
QG
Sz
eX
oX
Sz
Sz
QG
qK
qK
QG
qK
qK
QG
Sz
Sz
Sz
eX
eX
my
my
my
my
my
my
my
my
my
my
my
my
my
my
my
my
my
my
my
my
my
my
"}
(7,1,1) = {"
my
my
my
eX
eX
Sz
QG
hQ
hQ
JY
hQ
hQ
xJ
hQ
hQ
qK
oX
hH
oX
oX
QG
QG
hQ
hQ
nx
hQ
hQ
QG
QG
QG
Sz
Sz
eX
eX
my
my
my
my
my
my
my
my
my
my
my
my
my
my
my
my
my
my
my
my
my
"}
(8,1,1) = {"
my
my
my
eX
eX
Sz
qK
hQ
hQ
hQ
hQ
hQ
np
hQ
hQ
qK
oX
oX
QG
Ov
oX
hQ
hQ
hQ
hQ
hQ
hQ
KP
hQ
QG
QG
Sz
Sz
eX
eX
my
my
my
my
my
my
my
my
my
my
my
my
my
my
my
my
my
my
my
my
"}
(9,1,1) = {"
my
my
my
eX
eX
Sz
qK
hQ
hQ
hQ
hQ
hQ
hQ
hQ
hQ
qK
Sz
oX
QG
hQ
oX
oX
hQ
hQ
MX
hQ
LN
LN
KP
pS
QG
QG
Sz
Sz
eX
my
my
my
my
my
my
my
my
my
my
my
my
my
my
my
my
my
my
my
my
"}
(10,1,1) = {"
my
my
my
eX
eX
Sz
qK
hQ
hQ
hQ
hQ
hQ
KP
KP
oX
Ov
Ov
Ov
Ov
oX
hQ
LC
hQ
np
hQ
hQ
LN
Nt
hp
np
hQ
QG
QG
Sz
eX
eX
eX
eX
eX
eX
eX
eX
eX
eX
eX
eX
eX
eX
eX
eX
eX
eX
eX
eX
my
"}
(11,1,1) = {"
my
eX
eX
eX
eX
Sz
QG
hQ
hQ
ay
hQ
hQ
hY
hQ
oX
QG
QG
hQ
KP
oX
oX
hQ
hQ
hQ
hQ
hQ
hp
LN
LN
LN
hQ
hQ
QG
Sz
Sz
eX
eX
eX
eX
eX
eX
eX
eX
eX
eX
eX
eX
eX
eX
eX
eX
eX
eX
eX
my
"}
(12,1,1) = {"
my
eX
eX
QG
QG
QG
QG
hQ
hQ
hQ
hQ
KP
KP
hQ
hQ
QG
QG
hQ
hQ
Nr
KP
oX
hQ
hQ
hQ
hQ
LN
gG
LN
Nt
hp
hQ
QG
QG
Sz
Sz
Sz
Sz
Sz
Sz
Sz
Sz
oX
Sz
Sz
Sz
Sz
Sz
Sz
Sz
Sz
Sz
eX
eX
my
"}
(13,1,1) = {"
my
eX
eX
QG
ZK
QG
QG
hQ
hQ
hQ
hQ
KP
hQ
Cv
hQ
QG
nx
hQ
hQ
hQ
KP
hQ
hQ
hQ
vc
hQ
LN
LN
LN
LN
LN
hQ
nx
QG
qK
qK
qK
QG
QG
qK
qK
FO
Ov
QG
QG
qK
qK
qK
QG
QG
QG
Sz
eX
eX
my
"}
(14,1,1) = {"
my
eX
eX
QG
hQ
tp
QG
hQ
hQ
hQ
hQ
hQ
hQ
hQ
Cv
er
hQ
hQ
hQ
hQ
hQ
hQ
hQ
hQ
hQ
hQ
hQ
mb
mb
mb
hQ
hQ
Cv
er
hQ
KP
hQ
nx
hQ
hQ
Uf
oX
hQ
nx
hQ
Cv
KP
KP
KP
nx
ps
Sz
eX
eX
my
"}
(15,1,1) = {"
my
eX
eX
QG
hQ
hQ
DM
Yy
hQ
hQ
hQ
hQ
hQ
hQ
hQ
hQ
hQ
hQ
sZ
hQ
hQ
hQ
hQ
hQ
qa
hQ
hQ
mb
gp
SV
hQ
hQ
hQ
KP
MN
MN
LN
LN
LN
oX
oX
oX
LN
MN
LN
LN
fo
LN
LN
LN
QG
Sz
eX
eX
my
"}
(16,1,1) = {"
my
eX
eX
QG
Cv
gb
QG
hQ
np
hQ
hQ
hQ
hQ
hQ
Cv
er
hQ
hQ
hQ
hQ
hQ
hQ
hQ
hQ
hQ
hQ
hQ
mb
mb
mb
hQ
Cv
KP
Kg
hQ
hQ
hQ
hX
np
oX
oX
KP
xC
hX
hQ
Se
Se
yR
hQ
hX
xh
Sz
eX
eX
my
"}
(17,1,1) = {"
my
eX
eX
QG
HJ
QG
QG
hQ
hQ
hQ
hQ
hQ
hQ
hQ
hQ
QG
hX
hQ
hQ
hQ
hQ
hQ
hQ
hQ
hQ
hQ
Dm
Dm
au
Dm
Dm
hQ
hX
QG
qK
qK
qK
QG
QG
FO
FO
qK
QG
QG
QG
JR
JR
JR
QG
QG
QG
Sz
eX
eX
my
"}
(18,1,1) = {"
my
eX
eX
QG
QG
QG
QG
hQ
hQ
hQ
hQ
hQ
hQ
hQ
hQ
QG
QG
hQ
hQ
pw
hQ
hQ
hQ
hQ
hQ
hQ
LN
Nt
LN
Xv
Je
hQ
QG
QG
Sz
Sz
Sz
Sz
Sz
Sz
oX
Sz
Sz
Sz
Sz
Sz
Sz
Sz
Sz
Sz
Sz
Sz
eX
eX
my
"}
(19,1,1) = {"
my
eX
eX
eX
eX
Sz
QG
hQ
hQ
hY
KP
hQ
OE
hQ
hQ
QG
QG
hQ
hQ
hQ
hQ
KP
KP
hQ
hQ
hQ
LN
LN
LN
LN
hQ
hQ
QG
Sz
Sz
eX
eX
eX
eX
eX
eX
eX
eX
eX
eX
eX
eX
eX
eX
eX
eX
eX
eX
eX
my
"}
(20,1,1) = {"
my
my
my
eX
eX
Sz
qK
KP
KP
hQ
hQ
hQ
hQ
hQ
hQ
QG
QG
QG
hQ
np
KP
Nr
hQ
hQ
hQ
hQ
hp
LN
hp
hQ
hQ
QG
QG
Sz
eX
eX
eX
eX
eX
eX
eX
eX
eX
eX
eX
eX
eX
eX
eX
eX
eX
eX
eX
eX
my
"}
(21,1,1) = {"
my
my
my
eX
eX
Sz
qK
KP
hQ
hQ
hQ
hQ
hQ
hQ
hQ
qK
Sz
QG
QG
hX
KP
hQ
hQ
hQ
gz
hQ
LN
Je
np
hX
QG
QG
Sz
Sz
eX
eX
my
my
my
my
my
my
my
my
my
my
my
my
my
my
my
my
my
my
my
"}
(22,1,1) = {"
my
my
my
eX
eX
Sz
qK
hQ
hQ
hQ
hQ
np
hQ
hQ
hQ
qK
Sz
Sz
QG
QG
hQ
hQ
hQ
hQ
KP
KP
hQ
hQ
hQ
QG
QG
Sz
Sz
eX
eX
my
my
my
my
my
my
my
my
my
my
my
my
my
my
my
my
my
my
my
my
"}
(23,1,1) = {"
my
my
my
eX
eX
Sz
QG
hQ
hQ
rW
hQ
hQ
CK
hQ
hQ
qK
Sz
Sz
Sz
QG
QG
QG
hQ
KP
xX
hQ
hQ
QG
QG
QG
Sz
Sz
eX
eX
my
my
my
my
my
my
my
my
my
my
my
my
my
my
my
my
my
my
my
my
my
"}
(24,1,1) = {"
my
my
my
eX
eX
Sz
QG
QG
hQ
hQ
hQ
hQ
hQ
hQ
QG
QG
Sz
eX
Sz
Sz
Sz
QG
qK
qK
QG
qK
qK
QG
Sz
Sz
Sz
eX
eX
my
my
my
my
my
my
my
my
my
my
my
my
my
my
my
my
my
my
my
my
my
my
"}
(25,1,1) = {"
my
my
my
eX
eX
Sz
Sz
QG
QG
hX
hQ
hQ
hX
QG
QG
Sz
Sz
eX
eX
eX
Sz
Sz
Sz
Sz
Sz
Sz
Sz
Sz
Sz
eX
eX
eX
my
my
my
my
my
my
my
my
my
my
my
my
my
my
my
my
my
my
my
my
my
my
my
"}
(26,1,1) = {"
my
my
my
my
eX
eX
Sz
Sz
QG
QG
qK
qK
QG
QG
Sz
Sz
eX
eX
eX
eX
eX
eX
eX
eX
eX
eX
eX
eX
eX
eX
eX
my
my
my
my
my
my
my
my
my
my
my
my
my
my
my
my
my
my
my
my
my
my
my
my
"}
(27,1,1) = {"
my
my
my
my
my
eX
eX
Sz
Sz
Sz
Sz
Sz
Sz
Sz
Sz
eX
eX
eX
my
eX
eX
eX
eX
eX
eX
eX
eX
eX
eX
eX
my
my
my
my
my
my
my
my
my
my
my
my
my
my
my
my
my
my
my
my
my
my
my
my
my
"}
(28,1,1) = {"
my
my
my
my
my
my
eX
eX
eX
eX
eX
eX
eX
eX
eX
eX
eX
my
my
my
my
my
my
my
my
my
my
my
my
my
my
my
my
my
my
my
my
my
my
my
my
my
my
my
my
my
my
my
my
my
my
my
my
my
my
"}
(29,1,1) = {"
my
my
my
my
my
my
eX
eX
eX
eX
eX
eX
eX
eX
eX
eX
my
my
my
my
my
my
my
my
my
my
my
my
my
my
my
my
my
my
my
my
my
my
my
my
my
my
my
my
my
my
my
my
my
my
my
my
my
my
my
"}
(30,1,1) = {"
my
my
my
my
my
my
my
my
my
my
my
my
my
my
my
my
my
my
my
my
my
my
my
my
my
my
my
my
my
my
my
my
my
my
my
my
my
my
my
my
my
my
my
my
my
my
my
my
my
my
my
my
my
my
my
"}
