//MAP CONVERTED BY dmm2tgm.py THIS HEADER COMMENT PREVENTS RECONVERSION, DO NOT REMOVE
"bc" = (
/obj/structure/fluff/minepost,
/turf/open/floor/stone/icemoon,
/area/ruin/unpowered/primitive_catgirl_den)
"bl" = (
/obj/effect/turf_decal/siding/wood{
	dir = 1
	},
/obj/structure/railing/wooden_fencing{
	dir = 1
	},
/turf/open/floor/wood/icemoon,
/area/ruin/unpowered/primitive_catgirl_den)
"bu" = (
/obj/effect/turf_decal/siding/wood,
/obj/effect/turf_decal/siding/wood/corner{
	dir = 1
	},
/turf/open/misc/dirt/icemoon,
/area/ruin/unpowered/primitive_catgirl_den)
"bJ" = (
/obj/structure/wall_torch/spawns_lit/directional/east,
/obj/structure/curtain/bounty,
/obj/effect/turf_decal/siding/wood{
	dir = 1
	},
/turf/open/misc/dirt/icemoon,
/area/ruin/unpowered/primitive_catgirl_den)
"cv" = (
/turf/open/floor/stone/icemoon,
/area/ruin/unpowered/primitive_catgirl_den)
"cy" = (
/turf/open/misc/grass/roofing,
/area/ruin/unpowered/primitive_catgirl_den)
"cA" = (
/obj/structure/flora/ash/chilly,
/turf/open/misc/asteroid/snow/icemoon,
/area/ruin/unpowered/primitive_catgirl_den)
"cD" = (
/obj/effect/turf_decal/siding/wood{
	dir = 8
	},
/obj/effect/turf_decal/weather/snow/corner{
	dir = 8
	},
/turf/open/floor/wood/icemoon,
/area/ruin/unpowered/primitive_catgirl_den)
"cI" = (
/obj/effect/turf_decal/siding/wood{
	dir = 8
	},
/obj/effect/turf_decal/siding/wood{
	dir = 4
	},
/obj/effect/turf_decal/weather/snow/corner{
	dir = 8
	},
/obj/effect/turf_decal/weather/snow/corner{
	dir = 4
	},
/turf/open/floor/wood/icemoon,
/area/ruin/unpowered/primitive_catgirl_den)
"cZ" = (
/obj/structure/curtain/bounty,
/obj/structure/bed/double/pelt,
/turf/open/floor/stone/icemoon,
/area/ruin/unpowered/primitive_catgirl_den)
"di" = (
/obj/effect/turf_decal/weather/snow/corner{
	dir = 10
	},
/turf/open/openspace/icemoon,
/area/ruin/unpowered/primitive_catgirl_den)
"dk" = (
/obj/structure/railing/wooden_fencing{
	dir = 1
	},
/turf/open/misc/asteroid/snow/icemoon,
/area/ruin/unpowered/primitive_catgirl_den)
"eA" = (
/obj/structure/rack/wooden,
/obj/item/hemostat/ashwalker{
	pixel_y = 6
	},
/obj/item/retractor/ashwalker{
	pixel_y = -9
	},
/turf/open/floor/stone/icemoon,
/area/ruin/unpowered/primitive_catgirl_den)
"fr" = (
/obj/effect/turf_decal/weather/snow/corner,
/obj/effect/turf_decal/weather/snow/corner{
	dir = 1
	},
/obj/structure/mineral_door/wood/large_gate{
	dir = 8
	},
/turf/open/misc/dirt/icemoon,
/area/ruin/unpowered/primitive_catgirl_den)
"fx" = (
/obj/effect/turf_decal/weather/snow/corner{
	dir = 4
	},
/obj/effect/turf_decal/weather/snow/corner{
	dir = 8
	},
/turf/open/misc/dirt/icemoon,
/area/ruin/unpowered/primitive_catgirl_den)
"fN" = (
/obj/effect/turf_decal/weather/snow/corner{
	dir = 6
	},
/obj/effect/turf_decal/weather/snow/corner{
	dir = 1
	},
/turf/open/misc/dirt/icemoon,
/area/ruin/unpowered/primitive_catgirl_den)
"fV" = (
/obj/effect/turf_decal/siding/wood{
	dir = 9
	},
/obj/structure/railing/wooden_fencing{
	dir = 1
	},
/obj/structure/railing/wooden_fencing{
	dir = 8
	},
/turf/open/floor/wood/icemoon,
/area/ruin/unpowered/primitive_catgirl_den)
"gq" = (
/obj/effect/turf_decal/weather/snow/corner{
	dir = 1
	},
/turf/open/openspace/icemoon,
/area/ruin/unpowered/primitive_catgirl_den)
"gt" = (
/obj/machinery/vending/primitive_catgirl_clothing_vendor,
/turf/open/floor/stone/icemoon,
/area/ruin/unpowered/primitive_catgirl_den)
"gu" = (
/obj/structure/railing/wooden_fencing{
	dir = 1
	},
/obj/structure/flora/ash/chilly,
/turf/open/misc/asteroid/snow/icemoon,
/area/ruin/unpowered/primitive_catgirl_den)
"gG" = (
/obj/effect/turf_decal/weather/snow/corner{
	dir = 8
	},
/turf/open/openspace/icemoon,
/area/ruin/unpowered/primitive_catgirl_den)
"gS" = (
/obj/structure/rack/wooden,
/obj/item/food/grown/tobacco{
	pixel_y = -4;
	pixel_x = -4
	},
/obj/item/food/grown/tobacco{
	pixel_y = -4;
	pixel_x = 2
	},
/obj/item/plate/oven_tray/material/fake_tin{
	pixel_y = 5
	},
/obj/item/plate/oven_tray/material/fake_brass{
	pixel_y = 8;
	pixel_x = 1
	},
/turf/open/floor/stone/icemoon,
/area/ruin/unpowered/primitive_catgirl_den)
"gW" = (
/obj/structure/wall_torch/spawns_lit/directional/west,
/obj/structure/curtain/bounty,
/obj/structure/bed/double/pelt,
/turf/open/floor/stone/icemoon,
/area/ruin/unpowered/primitive_catgirl_den)
"im" = (
/obj/effect/turf_decal/weather/snow/corner,
/obj/effect/turf_decal/weather/snow/corner{
	dir = 1
	},
/turf/open/misc/dirt/icemoon,
/area/ruin/unpowered/primitive_catgirl_den)
"iu" = (
/obj/structure/table/wood,
/obj/structure/large_mortar,
/obj/item/pestle{
	pixel_y = -1;
	pixel_x = -8
	},
/turf/open/floor/wood/icemoon,
/area/ruin/unpowered/primitive_catgirl_den)
"iJ" = (
/obj/effect/turf_decal/siding/wood{
	dir = 10
	},
/turf/open/floor/wood/icemoon,
/area/ruin/unpowered/primitive_catgirl_den)
"jt" = (
/obj/structure/wall_torch/spawns_lit/directional/south,
/turf/open/misc/asteroid/snow/icemoon,
/area/ruin/unpowered/primitive_catgirl_den)
"ki" = (
/obj/structure/railing/wooden_fencing,
/turf/open/misc/grass/roofing,
/area/ruin/unpowered/primitive_catgirl_den)
"kO" = (
/obj/structure/wall_torch/spawns_lit/directional/south,
/obj/effect/turf_decal/weather/snow/corner{
	dir = 1
	},
/turf/open/floor/wood/icemoon,
/area/ruin/unpowered/primitive_catgirl_den)
"lv" = (
/obj/effect/turf_decal/weather/snow/corner{
	dir = 10
	},
/turf/open/misc/grass/roofing,
/area/ruin/unpowered/primitive_catgirl_den)
"lN" = (
/obj/effect/turf_decal/weather/snow/corner{
	dir = 1
	},
/turf/open/misc/dirt/icemoon,
/area/ruin/unpowered/primitive_catgirl_den)
"mm" = (
/obj/effect/turf_decal/weather/snow/corner{
	dir = 1
	},
/obj/effect/turf_decal/weather/snow/corner,
/turf/open/misc/dirt/icemoon,
/area/ruin/unpowered/primitive_catgirl_den)
"mH" = (
/obj/structure/mineral_door/wood/large_gate{
	dir = 8
	},
/turf/open/floor/wood/icemoon,
/area/ruin/unpowered/primitive_catgirl_den)
"mM" = (
/obj/effect/turf_decal/siding/wood{
	dir = 6
	},
/turf/open/floor/wood/icemoon,
/area/ruin/unpowered/primitive_catgirl_den)
"nd" = (
/turf/open/misc/asteroid/snow/icemoon,
/area/ruin/unpowered/primitive_catgirl_den)
"nq" = (
/obj/structure/bed/double/pelt,
/turf/open/floor/stone/icemoon,
/area/ruin/unpowered/primitive_catgirl_den)
"nu" = (
/obj/effect/turf_decal/weather/snow/corner{
	dir = 10
	},
/obj/effect/turf_decal/weather/snow/corner{
	dir = 1
	},
/turf/open/misc/dirt/icemoon,
/area/ruin/unpowered/primitive_catgirl_den)
"nz" = (
/obj/structure/wall_torch/spawns_lit/directional/east,
/turf/open/misc/asteroid/snow/icemoon,
/area/ruin/unpowered/primitive_catgirl_den)
"nV" = (
/obj/effect/turf_decal/weather/snow/corner{
	dir = 8
	},
/turf/open/floor/wood/icemoon,
/area/ruin/unpowered/primitive_catgirl_den)
"os" = (
/obj/structure/flora/bush/sparsegrass/style_random,
/turf/open/misc/asteroid/snow/icemoon,
/area/ruin/unpowered/primitive_catgirl_den)
"ox" = (
/obj/effect/turf_decal/weather/snow/corner{
	dir = 9
	},
/turf/open/openspace/icemoon,
/area/ruin/unpowered/primitive_catgirl_den)
"pa" = (
/obj/structure/wall_torch/spawns_lit/directional/north,
/obj/item/pillow/random{
	pixel_y = 4
	},
/turf/open/floor/stone/icemoon,
/area/ruin/unpowered/primitive_catgirl_den)
"pk" = (
/obj/structure/wall_torch/spawns_lit/directional/east,
/obj/effect/turf_decal/siding/wood{
	dir = 8
	},
/turf/open/misc/dirt/icemoon,
/area/ruin/unpowered/primitive_catgirl_den)
"pl" = (
/obj/structure/sign/flag{
	pixel_y = 30
	},
/turf/open/misc/grass/roofing,
/area/ruin/unpowered/primitive_catgirl_den)
"pq" = (
/obj/effect/turf_decal/siding/wood{
	dir = 4
	},
/turf/open/misc/dirt/icemoon,
/area/ruin/unpowered/primitive_catgirl_den)
"pQ" = (
/obj/effect/turf_decal/weather/snow/corner{
	dir = 6
	},
/turf/open/misc/dirt/icemoon,
/area/ruin/unpowered/primitive_catgirl_den)
"pU" = (
/obj/structure/wall_torch/spawns_lit/directional/south,
/turf/open/floor/stone/icemoon,
/area/ruin/unpowered/primitive_catgirl_den)
"pX" = (
/obj/effect/turf_decal/weather/snow/corner{
	dir = 8
	},
/obj/effect/turf_decal/weather/snow/corner,
/turf/open/openspace/icemoon,
/area/ruin/unpowered/primitive_catgirl_den)
"qg" = (
/obj/effect/turf_decal/weather/snow/corner{
	dir = 9
	},
/turf/open/misc/dirt/icemoon,
/area/ruin/unpowered/primitive_catgirl_den)
"qQ" = (
/turf/closed/wall/mineral/stone,
/area/ruin/unpowered/primitive_catgirl_den)
"ry" = (
/obj/effect/turf_decal/siding/wood/corner{
	dir = 4
	},
/turf/open/misc/dirt/icemoon,
/area/ruin/unpowered/primitive_catgirl_den)
"rC" = (
/obj/structure/railing/wooden_fencing{
	dir = 8
	},
/turf/open/openspace/icemoon,
/area/ruin/unpowered/primitive_catgirl_den)
"rT" = (
/obj/effect/turf_decal/siding/wood{
	dir = 8
	},
/obj/structure/railing/wooden_fencing{
	dir = 8
	},
/obj/effect/turf_decal/weather/snow/corner{
	dir = 8
	},
/turf/open/floor/wood/icemoon,
/area/ruin/unpowered/primitive_catgirl_den)
"ta" = (
/obj/effect/turf_decal/weather/snow/corner,
/turf/open/misc/asteroid/snow/icemoon,
/area/ruin/unpowered/primitive_catgirl_den)
"tx" = (
/obj/structure/mineral_door/wood/large_gate{
	dir = 1
	},
/obj/effect/turf_decal/siding/wood/corner,
/turf/open/floor/wood/icemoon,
/area/ruin/unpowered/primitive_catgirl_den)
"tB" = (
/obj/structure/wall_torch/spawns_lit/directional/west,
/obj/effect/turf_decal/siding/wood{
	dir = 1
	},
/obj/structure/curtain/bounty,
/obj/effect/turf_decal/siding/wood{
	dir = 1
	},
/turf/open/misc/dirt/icemoon,
/area/ruin/unpowered/primitive_catgirl_den)
"ua" = (
/obj/structure/railing/wooden_fencing{
	dir = 1
	},
/obj/structure/railing/wooden_fencing{
	dir = 4
	},
/turf/open/misc/asteroid/snow/icemoon,
/area/ruin/unpowered/primitive_catgirl_den)
"ur" = (
/obj/effect/turf_decal/siding/wood/corner{
	dir = 8
	},
/obj/structure/mineral_door/wood/large_gate,
/turf/open/floor/wood/icemoon,
/area/ruin/unpowered/primitive_catgirl_den)
"uO" = (
/obj/structure/window/green_glass_pane,
/obj/structure/curtain/bounty,
/turf/closed/wall/mineral/wood/nonmetal,
/area/ruin/unpowered/primitive_catgirl_den)
"vW" = (
/obj/item/food/grown/aloe{
	pixel_x = 5
	},
/obj/item/food/grown/aloe,
/obj/item/food/grown/aloe{
	pixel_y = 5
	},
/obj/structure/closet/crate/wooden/storage_barrel,
/turf/open/floor/stone/icemoon,
/area/ruin/unpowered/primitive_catgirl_den)
"wF" = (
/obj/effect/turf_decal/siding/wood{
	dir = 10
	},
/obj/structure/railing/wooden_fencing{
	dir = 8
	},
/obj/structure/railing/wooden_fencing,
/turf/open/floor/wood/icemoon,
/area/ruin/unpowered/primitive_catgirl_den)
"xA" = (
/obj/effect/turf_decal/weather/snow/corner{
	dir = 8
	},
/turf/open/misc/dirt/icemoon,
/area/ruin/unpowered/primitive_catgirl_den)
"xM" = (
/obj/effect/turf_decal/weather/snow/corner{
	dir = 4
	},
/obj/structure/railing/wooden_fencing{
	dir = 4
	},
/turf/open/misc/grass/roofing,
/area/ruin/unpowered/primitive_catgirl_den)
"zr" = (
/obj/structure/bed/double/pelt/black{
	dir = 1
	},
/turf/open/floor/stone/icemoon,
/area/ruin/unpowered/primitive_catgirl_den)
"Ak" = (
/obj/item/pillow/random{
	pixel_y = 4
	},
/turf/open/floor/stone/icemoon,
/area/ruin/unpowered/primitive_catgirl_den)
"Al" = (
/obj/effect/turf_decal/siding/wood{
	dir = 8
	},
/turf/open/misc/dirt/icemoon,
/area/ruin/unpowered/primitive_catgirl_den)
"AT" = (
/obj/effect/turf_decal/siding/wood{
	dir = 1
	},
/obj/structure/railing/wooden_fencing{
	dir = 1
	},
/obj/structure/chair/wood,
/turf/open/floor/wood/icemoon,
/area/ruin/unpowered/primitive_catgirl_den)
"AV" = (
/obj/effect/turf_decal/weather/snow/corner{
	dir = 4
	},
/obj/effect/turf_decal/weather/snow/corner{
	dir = 8
	},
/turf/open/floor/wood/icemoon,
/area/ruin/unpowered/primitive_catgirl_den)
"Bt" = (
/turf/open/floor/wood/icemoon,
/area/ruin/unpowered/primitive_catgirl_den)
"BE" = (
/obj/effect/turf_decal/weather/snow/corner{
	dir = 8
	},
/obj/effect/turf_decal/weather/snow/corner{
	dir = 4
	},
/turf/open/misc/dirt/icemoon,
/area/ruin/unpowered/primitive_catgirl_den)
"BR" = (
/obj/effect/turf_decal/siding/wood{
	dir = 1
	},
/turf/open/floor/wood/icemoon,
/area/ruin/unpowered/primitive_catgirl_den)
"BW" = (
/obj/structure/dresser,
/turf/open/floor/stone/icemoon,
/area/ruin/unpowered/primitive_catgirl_den)
"Cp" = (
/obj/structure/rack/wooden,
/obj/item/reagent_containers/cup/mortar{
	pixel_y = 9;
	pixel_x = 5
	},
/obj/item/smelling_salts{
	pixel_y = -9;
	pixel_x = -5
	},
/obj/item/smelling_salts{
	pixel_y = -9;
	pixel_x = 6
	},
/turf/open/floor/wood/icemoon,
/area/ruin/unpowered/primitive_catgirl_den)
"Dm" = (
/obj/effect/turf_decal/siding/wood/corner{
	dir = 8
	},
/turf/open/misc/dirt/icemoon,
/area/ruin/unpowered/primitive_catgirl_den)
"Ej" = (
/obj/structure/rack/wooden,
/obj/item/bedsheet/black{
	pixel_x = 5;
	pixel_y = -2
	},
/obj/item/bedsheet/black{
	pixel_x = 5;
	pixel_y = 12
	},
/turf/open/floor/stone/icemoon,
/area/ruin/unpowered/primitive_catgirl_den)
"Ez" = (
/turf/open/openspace/icemoon,
/area/ruin/unpowered/primitive_catgirl_den)
"FJ" = (
/obj/effect/turf_decal/siding/wood{
	dir = 5
	},
/obj/structure/railing/wooden_fencing{
	dir = 1
	},
/obj/structure/railing/wooden_fencing{
	dir = 4
	},
/obj/structure/chair/wood{
	dir = 8
	},
/turf/open/floor/wood/icemoon,
/area/ruin/unpowered/primitive_catgirl_den)
"Go" = (
/obj/machinery/smartfridge/drying_rack,
/turf/open/floor/stone/icemoon,
/area/ruin/unpowered/primitive_catgirl_den)
"Gp" = (
/obj/structure/rack/wooden,
/obj/item/reagent_containers/cup/bucket/wooden,
/obj/item/reagent_containers/cup/bucket/wooden{
	pixel_y = -3;
	pixel_x = 8
	},
/turf/open/misc/dirt/icemoon,
/area/ruin/unpowered/primitive_catgirl_den)
"Gw" = (
/turf/open/misc/dirt/icemoon,
/area/ruin/unpowered/primitive_catgirl_den)
"GO" = (
/obj/effect/turf_decal/siding/wood/corner,
/obj/structure/closet/crate/wooden/storage_barrel,
/obj/item/reagent_containers/cup/glass/bottle/moonshine{
	pixel_x = -6
	},
/obj/item/reagent_containers/cup/glass/bottle/moonshine{
	pixel_x = 8
	},
/obj/item/reagent_containers/cup/glass/bottle/hooch{
	pixel_y = 8
	},
/turf/open/misc/dirt/icemoon,
/area/ruin/unpowered/primitive_catgirl_den)
"Hi" = (
/obj/effect/turf_decal/weather/snow/corner,
/turf/open/openspace/icemoon,
/area/ruin/unpowered/primitive_catgirl_den)
"HF" = (
/obj/effect/turf_decal/siding/wood{
	dir = 8
	},
/obj/structure/window/green_glass_pane,
/obj/structure/curtain/bounty,
/obj/effect/turf_decal/siding/wood{
	dir = 4
	},
/turf/open/floor/wood/icemoon,
/area/ruin/unpowered/primitive_catgirl_den)
"HW" = (
/obj/effect/turf_decal/weather/snow/corner{
	dir = 1
	},
/turf/open/floor/wood/icemoon,
/area/ruin/unpowered/primitive_catgirl_den)
"IC" = (
/obj/effect/turf_decal/siding/wood/corner,
/obj/effect/turf_decal/siding/wood/corner{
	dir = 4
	},
/turf/open/floor/wood/icemoon,
/area/ruin/unpowered/primitive_catgirl_den)
"Jw" = (
/obj/effect/turf_decal/siding/wood,
/turf/open/misc/dirt/icemoon,
/area/ruin/unpowered/primitive_catgirl_den)
"JC" = (
/obj/structure/wall_torch/spawns_lit/directional/west,
/obj/structure/table/wood,
/obj/structure/chem_separator{
	pixel_y = 12
	},
/turf/open/floor/wood/icemoon,
/area/ruin/unpowered/primitive_catgirl_den)
"JT" = (
/obj/structure/closet/crate/wooden/storage_barrel,
/obj/item/instrument/guitar,
/obj/item/instrument/glockenspiel,
/turf/open/floor/stone/icemoon,
/area/ruin/unpowered/primitive_catgirl_den)
"Kg" = (
/obj/structure/wall_torch/spawns_lit/directional/west,
/obj/effect/turf_decal/weather/snow/corner{
	dir = 4
	},
/turf/open/misc/dirt/icemoon,
/area/ruin/unpowered/primitive_catgirl_den)
"Kq" = (
/obj/structure/mineral_door/wood/large_gate,
/turf/open/floor/wood/icemoon,
/area/ruin/unpowered/primitive_catgirl_den)
"La" = (
/obj/structure/wall_torch/spawns_lit/directional/east,
/obj/structure/curtain/bounty,
/obj/structure/bed/double/pelt,
/turf/open/floor/stone/icemoon,
/area/ruin/unpowered/primitive_catgirl_den)
"Lf" = (
/obj/effect/turf_decal/weather/snow/corner,
/turf/open/misc/dirt/icemoon,
/area/ruin/unpowered/primitive_catgirl_den)
"LW" = (
/obj/structure/bed/double/pelt{
	dir = 1
	},
/turf/open/floor/stone/icemoon,
/area/ruin/unpowered/primitive_catgirl_den)
"Mh" = (
/obj/effect/turf_decal/weather/snow/corner{
	dir = 4
	},
/turf/open/openspace/icemoon,
/area/ruin/unpowered/primitive_catgirl_den)
"Mn" = (
/obj/effect/turf_decal/weather/snow/corner,
/turf/open/misc/grass/roofing,
/area/ruin/unpowered/primitive_catgirl_den)
"MD" = (
/obj/effect/turf_decal/weather/snow/corner{
	dir = 6
	},
/obj/structure/railing/wooden_fencing,
/obj/structure/railing/wooden_fencing{
	dir = 4
	},
/turf/open/misc/grass/roofing,
/area/ruin/unpowered/primitive_catgirl_den)
"Nu" = (
/obj/effect/turf_decal/siding/wood{
	dir = 8
	},
/turf/open/floor/wood/icemoon,
/area/ruin/unpowered/primitive_catgirl_den)
"NA" = (
/obj/structure/wall_torch/spawns_lit/directional/west,
/obj/effect/turf_decal/siding/wood{
	dir = 4
	},
/turf/open/misc/dirt/icemoon,
/area/ruin/unpowered/primitive_catgirl_den)
"NX" = (
/obj/effect/turf_decal/weather/snow/corner{
	dir = 4
	},
/turf/open/misc/dirt/icemoon,
/area/ruin/unpowered/primitive_catgirl_den)
"Ou" = (
/obj/structure/curtain/bounty,
/turf/open/floor/stone/icemoon,
/area/ruin/unpowered/primitive_catgirl_den)
"Pe" = (
/obj/structure/wall_torch/spawns_lit/directional/west,
/turf/open/misc/asteroid/snow/icemoon,
/area/ruin/unpowered/primitive_catgirl_den)
"Pr" = (
/obj/structure/rack/wooden,
/obj/item/cautery/ashwalker{
	pixel_y = 10
	},
/obj/item/scalpel/ashwalker{
	pixel_y = 6
	},
/obj/item/circular_saw/ashwalker{
	pixel_y = -9
	},
/obj/item/surgicaldrill/ashwalker{
	pixel_y = -7;
	pixel_x = 7
	},
/turf/open/floor/stone/icemoon,
/area/ruin/unpowered/primitive_catgirl_den)
"PK" = (
/obj/effect/turf_decal/siding/wood,
/obj/structure/railing/wooden_fencing,
/turf/open/floor/wood/icemoon,
/area/ruin/unpowered/primitive_catgirl_den)
"PN" = (
/obj/structure/wall_torch/spawns_lit/directional/east,
/obj/effect/turf_decal/siding/wood{
	dir = 4
	},
/turf/open/floor/wood/icemoon,
/area/ruin/unpowered/primitive_catgirl_den)
"Qi" = (
/obj/effect/turf_decal/siding/wood{
	dir = 10
	},
/obj/structure/railing/wooden_fencing{
	dir = 8
	},
/obj/structure/railing/wooden_fencing,
/obj/effect/turf_decal/weather/snow/corner{
	dir = 8
	},
/turf/open/floor/wood/icemoon,
/area/ruin/unpowered/primitive_catgirl_den)
"Rb" = (
/obj/effect/turf_decal/siding/wood{
	dir = 4
	},
/turf/open/floor/wood/icemoon,
/area/ruin/unpowered/primitive_catgirl_den)
"Ri" = (
/obj/effect/turf_decal/weather/snow/corner{
	dir = 6
	},
/turf/open/openspace/icemoon,
/area/ruin/unpowered/primitive_catgirl_den)
"Rj" = (
/obj/structure/wall_torch/spawns_lit/directional/east,
/obj/structure/table/wood,
/obj/item/paper_bin/bundlenatural{
	pixel_y = 8;
	pixel_x = 3
	},
/obj/item/pen/charcoal,
/obj/item/reagent_containers/cup/primitive_centrifuge{
	pixel_x = -14;
	pixel_y = -1
	},
/turf/open/floor/wood/icemoon,
/area/ruin/unpowered/primitive_catgirl_den)
"Rk" = (
/obj/effect/turf_decal/siding/wood{
	dir = 4
	},
/obj/structure/railing/wooden_fencing{
	dir = 4
	},
/turf/open/floor/wood/icemoon,
/area/ruin/unpowered/primitive_catgirl_den)
"Rq" = (
/obj/effect/turf_decal/siding/wood{
	dir = 6
	},
/turf/open/misc/dirt/icemoon,
/area/ruin/unpowered/primitive_catgirl_den)
"RI" = (
/obj/effect/turf_decal/siding/wood/corner,
/obj/effect/turf_decal/siding/wood{
	dir = 1
	},
/obj/structure/fluff/minepost,
/turf/open/misc/dirt/icemoon,
/area/ruin/unpowered/primitive_catgirl_den)
"Sj" = (
/obj/effect/turf_decal/siding/wood{
	dir = 5
	},
/obj/structure/railing/wooden_fencing{
	dir = 1
	},
/obj/structure/railing/wooden_fencing{
	dir = 4
	},
/obj/structure/chair/wood,
/turf/open/floor/wood/icemoon,
/area/ruin/unpowered/primitive_catgirl_den)
"Sl" = (
/obj/structure/wall_torch/spawns_lit/directional/north,
/turf/open/misc/asteroid/snow/icemoon,
/area/ruin/unpowered/primitive_catgirl_den)
"Sq" = (
/obj/structure/flora/tree/pine/style_random,
/turf/open/misc/asteroid/snow/icemoon,
/area/ruin/unpowered/primitive_catgirl_den)
"Su" = (
/obj/effect/turf_decal/weather/snow/corner{
	dir = 5
	},
/turf/open/openspace/icemoon,
/area/ruin/unpowered/primitive_catgirl_den)
"SU" = (
/obj/structure/railing/wooden_fencing{
	dir = 4
	},
/obj/structure/railing/wooden_fencing{
	dir = 1
	},
/turf/open/misc/asteroid/snow/icemoon,
/area/ruin/unpowered/primitive_catgirl_den)
"Tg" = (
/obj/effect/turf_decal/siding/wood{
	dir = 5
	},
/obj/structure/railing/wooden_fencing{
	dir = 1
	},
/obj/structure/railing/wooden_fencing{
	dir = 4
	},
/turf/open/floor/wood/icemoon,
/area/ruin/unpowered/primitive_catgirl_den)
"Tn" = (
/obj/effect/turf_decal/siding/wood/corner{
	dir = 1
	},
/obj/structure/curtain/bounty,
/obj/effect/turf_decal/siding/wood{
	dir = 1
	},
/turf/open/misc/dirt/icemoon,
/area/ruin/unpowered/primitive_catgirl_den)
"Tu" = (
/obj/structure/wall_torch/spawns_lit/directional/south,
/obj/item/pillow/random{
	pixel_y = 4
	},
/turf/open/floor/stone/icemoon,
/area/ruin/unpowered/primitive_catgirl_den)
"TM" = (
/obj/effect/turf_decal/weather/snow/corner{
	dir = 5
	},
/turf/open/floor/wood/icemoon,
/area/ruin/unpowered/primitive_catgirl_den)
"Uo" = (
/turf/closed/wall/mineral/wood/nonmetal,
/area/ruin/unpowered/primitive_catgirl_den)
"UD" = (
/obj/effect/turf_decal/siding/wood{
	dir = 6
	},
/obj/structure/railing/wooden_fencing{
	dir = 4
	},
/obj/structure/railing/wooden_fencing,
/turf/open/floor/wood/icemoon,
/area/ruin/unpowered/primitive_catgirl_den)
"Va" = (
/obj/structure/wall_torch/spawns_lit/directional/north,
/turf/open/floor/stone/icemoon,
/area/ruin/unpowered/primitive_catgirl_den)
"Vj" = (
/obj/effect/turf_decal/siding/wood,
/turf/open/floor/wood/icemoon,
/area/ruin/unpowered/primitive_catgirl_den)
"Vv" = (
/obj/structure/window/green_glass_pane,
/obj/structure/curtain/bounty,
/turf/open/floor/wood/icemoon,
/area/ruin/unpowered/primitive_catgirl_den)
"Vw" = (
/obj/effect/turf_decal/weather/snow/corner{
	dir = 10
	},
/turf/open/misc/dirt/icemoon,
/area/ruin/unpowered/primitive_catgirl_den)
"VY" = (
/obj/effect/turf_decal/weather/snow/corner{
	dir = 5
	},
/turf/open/misc/dirt/icemoon,
/area/ruin/unpowered/primitive_catgirl_den)
"WO" = (
/obj/effect/turf_decal/weather/snow/corner,
/obj/structure/geyser,
/turf/open/misc/asteroid/snow/icemoon,
/area/ruin/unpowered/primitive_catgirl_den)
"Xa" = (
/obj/effect/turf_decal/siding/wood{
	dir = 4
	},
/obj/structure/closet/crate/wooden/storage_barrel,
/obj/item/stack/medical/aloe{
	pixel_y = -2
	},
/obj/item/stack/medical/aloe{
	pixel_y = 2;
	pixel_x = 2
	},
/obj/item/stack/medical/gauze/improvised{
	pixel_y = 6
	},
/turf/open/misc/dirt/icemoon,
/area/ruin/unpowered/primitive_catgirl_den)
"Xu" = (
/obj/structure/mineral_door/wood/large_gate{
	dir = 8
	},
/obj/effect/turf_decal/weather/snow/corner{
	dir = 1
	},
/obj/effect/turf_decal/weather/snow/corner,
/turf/open/misc/dirt/icemoon,
/area/ruin/unpowered/primitive_catgirl_den)
"XA" = (
/obj/effect/turf_decal/siding/wood/corner,
/turf/open/misc/dirt/icemoon,
/area/ruin/unpowered/primitive_catgirl_den)
"Yh" = (
/obj/effect/turf_decal/siding/wood{
	dir = 8
	},
/obj/structure/railing/wooden_fencing{
	dir = 8
	},
/turf/open/floor/wood/icemoon,
/area/ruin/unpowered/primitive_catgirl_den)
"Yn" = (
/turf/template_noop,
/area/ruin/unpowered/primitive_catgirl_den)
"YD" = (
/obj/structure/rack/wooden,
/obj/item/reagent_containers/cup/glass/bottle/small{
	pixel_x = -8
	},
/obj/item/reagent_containers/cup/glass/bottle/small{
	pixel_x = 1
	},
/obj/item/reagent_containers/cup/glass/bottle/small{
	pixel_x = 7
	},
/turf/open/floor/wood/icemoon,
/area/ruin/unpowered/primitive_catgirl_den)

(1,1,1) = {"
Yn
Yn
Yn
Yn
Yn
Yn
Yn
Yn
Yn
Yn
Yn
Yn
Yn
Yn
Yn
Yn
Yn
Yn
Yn
Yn
Yn
Yn
Yn
Yn
Yn
Yn
Yn
Yn
Yn
Yn
Yn
Yn
Yn
Yn
Yn
Yn
Yn
Yn
Yn
Yn
"}
(2,1,1) = {"
Yn
Yn
Ez
Ez
Ez
Ez
Ez
Ez
Ez
Ez
Ez
Ez
Ez
Ez
Ez
Ez
Ez
Ez
Ez
Ez
Ez
Ez
Ez
Ez
Ez
Ez
Ez
Ez
Ez
Ez
Ez
Ez
Ez
Ez
Ez
Ez
Ez
Ez
Yn
Yn
"}
(3,1,1) = {"
Yn
Yn
Ez
Ez
Ez
Ez
Ez
Ez
Ez
Ez
Ez
Ez
Ez
Ez
Ez
Ez
Ez
Ez
Ez
Ez
Ez
Ez
Ez
Ez
Ez
Ez
Ez
Ez
Ez
Ez
Ez
Ez
Ez
Ez
Ez
Ez
Ez
Ez
Ez
Yn
"}
(4,1,1) = {"
Yn
Ez
Ez
Ez
Ez
Ez
Ez
Ez
Ez
Ez
Ez
Ez
Ez
Ez
Ez
fV
Yh
wF
Ez
Ez
fV
Yh
wF
Ez
Ez
Ez
Ez
Ez
Ez
Ez
Ez
Ez
Ez
Ez
Ez
Ez
Ez
Ez
Ez
Yn
"}
(5,1,1) = {"
Yn
Ez
Ez
Ez
Ez
Ez
cy
cy
cy
cy
cy
cy
cy
cy
cy
AT
Bt
PK
Ez
Ez
bl
Bt
PK
Ez
cy
cy
cy
cy
cy
cy
cy
cy
cy
Ez
Ez
Ez
Ez
Ez
Ez
Yn
"}
(6,1,1) = {"
Yn
Ez
Ez
Ez
Ez
Ez
cy
cy
cy
cy
cy
cy
cy
cy
cy
Tg
Rb
UD
Ez
Ez
Tg
Rb
UD
Ez
cy
cy
cy
cy
cy
cy
cy
cy
cy
Ez
Ez
Ez
Ez
Ez
Ez
Yn
"}
(7,1,1) = {"
Yn
Ez
Ez
Ez
cy
cy
cy
cy
cy
ki
Ez
Ez
Ez
Ez
Ez
Ez
Ez
Ez
Ez
Ez
Ez
Ez
Ez
Ez
cy
cy
Uo
cy
cy
Uo
cy
cy
cy
cy
cy
cy
Ez
Ez
Ez
Yn
"}
(8,1,1) = {"
Ez
Ez
Ez
Ez
Ez
cy
cy
cy
cy
ki
Ez
Ez
Ez
Mh
Ez
Ez
Ez
Ez
Ez
Ez
Ez
Ez
Ez
Ez
cy
Uo
Uo
Uo
Uo
Uo
Uo
cy
cy
cy
cy
cy
cy
Ez
Ez
Yn
"}
(9,1,1) = {"
Ez
Ez
qQ
Vv
Vv
Vv
Vv
qQ
cy
ki
Ez
Mh
Ri
nd
gq
Ez
Mh
Mh
Mh
Ez
Ez
Ez
Ez
Ez
cy
cy
Uo
cy
cy
Uo
cy
cy
cy
Uo
cy
cy
cy
Ez
Ez
Yn
"}
(10,1,1) = {"
Ez
Ez
qQ
JT
Ak
Ak
cv
qQ
cy
ki
Ri
nd
Sq
nd
Su
Ri
nd
nd
nd
Su
Mh
Ez
Ez
Ez
cy
cy
cy
cy
cy
cy
cy
cy
cy
Uo
pl
cy
cy
Ez
Ez
Yn
"}
(11,1,1) = {"
Ez
qQ
qQ
pa
cv
cv
Tu
qQ
xM
MD
nd
nd
nd
nd
nd
nd
nd
os
nd
nd
nd
gq
Ez
Ez
cy
cy
cy
cy
cy
cy
cy
cy
cy
Uo
cy
cy
cy
Ez
Ez
Yn
"}
(12,1,1) = {"
Ez
Vv
cv
cv
cv
Bt
Bt
qQ
Sl
nd
qQ
Uo
uO
Uo
uO
Uo
Uo
uO
Uo
qQ
nd
gq
Ez
Ez
cy
cy
cy
Ez
Ez
cy
cy
cy
cy
Uo
cy
cy
cy
Ez
Ez
Yn
"}
(13,1,1) = {"
Ez
Vv
Ak
cv
Bt
Bt
Bt
Kq
AV
nV
Uo
zr
pU
Uo
LW
pU
Uo
Va
LW
Uo
nd
Su
Ez
Ez
Ez
Ez
Ez
Ez
Ez
cy
cy
Uo
Uo
Uo
Uo
Uo
cy
Ez
Ez
Yn
"}
(14,1,1) = {"
Ez
qQ
rC
rC
rC
Bt
Bt
qQ
Sl
kO
Uo
Ou
Ou
Uo
Ou
Ou
Uo
Ou
Uo
Uo
nd
nd
gq
Ez
Ez
Ez
Ez
Ez
Ez
Ez
cy
cy
cy
Uo
cy
cy
cy
Ez
Ez
Yn
"}
(15,1,1) = {"
Ez
qQ
qQ
Ez
Ez
Bt
qQ
qQ
nd
HW
ur
Nu
Nu
Nu
Nu
Nu
Nu
iJ
BW
Uo
os
nd
gq
Ez
Ez
Ez
Ez
Ez
Ez
Ez
cy
cy
cy
Uo
cy
cy
cy
Ez
Ez
Yn
"}
(16,1,1) = {"
Ez
Ez
qQ
Uo
Uo
Uo
qQ
nd
nd
TM
tx
Rb
Rb
Rb
PN
IC
PN
mM
gt
Uo
cD
gG
Ez
Ez
Ez
Ez
cy
cy
Ez
Ez
cy
cy
cy
Uo
cy
cy
cy
Ez
Ez
Yn
"}
(17,1,1) = {"
Ez
Ez
Ez
Ri
nd
nd
nd
nd
nd
jt
Uo
Ou
Ou
Ou
Uo
Bt
Uo
Ou
Uo
Uo
Rb
Ez
Ez
Ez
Ez
cy
cy
cy
cy
cy
cy
Uo
Uo
Uo
Uo
Uo
cy
Ez
Ez
Yn
"}
(18,1,1) = {"
Yn
Ez
Hi
nd
nd
Sq
nd
os
nd
nd
Uo
nq
cv
pU
Uo
Bt
Uo
Va
zr
Uo
Lf
Su
Ez
Ez
Ez
cy
cy
cy
cy
cy
cy
cy
cy
Uo
cy
cy
cy
cy
Ez
Yn
"}
(19,1,1) = {"
Yn
Yn
Hi
nd
nd
nd
nd
nd
nd
nd
qQ
Uo
uO
Uo
Uo
mH
Uo
uO
Uo
qQ
Lf
nd
gq
Ez
Ez
cy
cy
cy
cy
cy
cy
cy
cy
Uo
pl
cy
cy
cy
Ez
Yn
"}
(20,1,1) = {"
Yn
Ez
Hi
nd
nd
cA
nd
nd
Sq
nd
nd
nd
nd
nd
Pe
lN
Kg
NX
Gw
NX
pQ
nd
gq
Ez
Ez
cy
cy
cy
cy
cy
cy
cy
cy
Uo
cy
cy
cy
cy
Ez
Yn
"}
(21,1,1) = {"
Yn
Ez
Ez
di
nd
nd
nd
nd
ox
di
nd
cA
nd
nd
nd
mm
ta
nd
mm
nd
nd
nd
gq
Ez
Ez
cy
cy
cy
cy
cy
cy
Uo
Uo
Uo
Uo
Uo
cy
cy
Ez
Yn
"}
(22,1,1) = {"
Yn
Ez
Ez
fV
rT
Qi
gG
gG
Ez
Hi
dk
nd
nu
os
nd
mm
ta
qg
Gw
xA
Vw
nd
gq
Ez
Ez
cy
cy
cy
cy
cy
cy
cy
cy
Uo
cy
cy
cy
cy
Ez
Yn
"}
(23,1,1) = {"
Yn
Ez
Ez
bl
Bt
Vj
Ez
Ez
Ez
Hi
dk
qg
Gw
Vw
nd
mm
ta
lN
Gw
Gw
Lf
nd
gq
Ez
Ez
cy
cy
cy
cy
cy
cy
cy
cy
Uo
cy
cy
cy
cy
Ez
Yn
"}
(24,1,1) = {"
Yn
Ez
Ez
FJ
Rk
UD
Ez
Ez
Ez
Hi
dk
lN
Gw
Lf
nd
mm
ta
lN
Gw
Gw
Lf
nd
gq
Ez
Ez
cy
cy
cy
cy
cy
cy
cy
cy
Uo
cy
cy
cy
cy
Ez
Yn
"}
(25,1,1) = {"
Yn
Ez
Ez
Ez
Ez
Ez
Ez
Ez
Ez
Hi
dk
lN
Gw
Lf
nd
mm
ta
lN
Gw
Gw
pQ
os
gq
Ez
Ez
Ez
cy
cy
cy
cy
cy
Uo
Uo
Uo
Uo
Uo
cy
cy
Ez
Yn
"}
(26,1,1) = {"
Yn
Ez
Ez
Ez
Ez
Ez
Ez
Ez
Ez
Hi
dk
lN
Gw
Lf
nd
mm
WO
lN
Gw
pQ
nd
nd
gq
Ez
Ez
Ez
Ez
cy
cy
cy
cy
cy
cy
Uo
cy
cy
cy
Ez
Ez
Yn
"}
(27,1,1) = {"
Yn
Ez
Ez
fV
Yh
wF
Ez
Ez
Ez
Hi
dk
VY
Gw
Lf
nd
mm
ta
lN
Lf
nd
nd
ox
Ez
Ez
Ez
Ez
Ez
cy
cy
cy
cy
cy
cy
Uo
pl
cy
cy
Ez
Ez
Yn
"}
(28,1,1) = {"
Yn
Ez
Ez
bl
Bt
Vj
Ez
Ez
Ez
Hi
SU
nd
lN
pQ
nd
mm
ta
lN
Lf
nd
ox
Ez
Ez
Ez
Ez
Ez
Ez
Ez
cy
cy
cy
cy
cy
Uo
cy
cy
Ez
Ez
Ez
Yn
"}
(29,1,1) = {"
Yn
Ez
Ez
Tg
Rk
UD
cy
Ez
Ez
cy
lv
dk
mm
nd
nd
mm
ta
lN
Lf
nd
Su
Mh
Mh
Mh
Mh
Mh
Mh
Ez
Ez
cy
cy
cy
cy
cy
cy
Ez
Ez
Ez
Ez
Yn
"}
(30,1,1) = {"
Yn
Ez
Ez
Ez
Ez
cy
cy
Ez
Ez
cy
Mn
dk
lN
BE
BE
NX
xA
Gw
Lf
nd
nd
nd
nd
nd
nd
nd
nd
Su
Ez
Ez
cy
cy
cy
cy
cy
Ez
Ez
Ez
Ez
Yn
"}
(31,1,1) = {"
Yn
Ez
Ez
Ez
Ez
cy
cy
Ez
Ez
cy
Mn
dk
mm
nd
nd
nd
VY
NX
Gw
fx
Vw
nd
nd
os
nd
nd
nd
nd
Su
Ez
Ez
Ez
fV
Yh
wF
Ez
Ez
Ez
Ez
Yn
"}
(32,1,1) = {"
Yn
Ez
Ez
Ez
Ez
Ez
Ez
Ez
Ez
Ez
Hi
dk
fN
nd
qQ
os
os
nd
qQ
nz
im
nz
qQ
nd
nd
cA
qQ
nd
nd
gq
Ez
Ez
BR
Bt
PK
Ez
Ez
Ez
Ez
Yn
"}
(33,1,1) = {"
Yn
Ez
Ez
Ez
Ez
cy
cy
Ez
Ez
Ez
Hi
dk
nd
nd
qQ
Uo
Vv
Uo
qQ
Uo
Xu
Uo
qQ
Uo
HF
Uo
qQ
nd
os
gq
Ez
Ez
Tg
Rk
UD
Ez
Ez
Ez
Ez
Yn
"}
(34,1,1) = {"
Yn
Ez
Ez
Ez
Ez
cy
cy
Ez
Ez
Ez
Hi
dk
nd
qQ
qQ
Pr
cZ
eA
qQ
Gw
Gw
Gw
qQ
Gp
GO
Xa
qQ
qQ
nd
gq
Ez
Ez
Ez
Ez
Ez
Ez
Ez
Ez
Ez
Yn
"}
(35,1,1) = {"
Yn
Ez
Ez
Ez
Ez
cy
cy
Ez
Ez
Ez
Hi
gu
nd
Uo
gW
cv
cv
cv
tB
XA
pq
pq
NA
ry
Jw
Bt
JC
Uo
nd
gq
Ez
Ez
Ez
Ez
Ez
Ez
Ez
Ez
Ez
Yn
"}
(36,1,1) = {"
Yn
Ez
Ez
Ez
Ez
Ez
Ez
Ez
Ez
Ez
Hi
ua
nd
Vv
Ej
cv
bc
cv
Tn
Jw
gS
Go
vW
RI
Rq
Bt
iu
Uo
nd
gq
Ez
Ez
fV
Yh
wF
Ez
Ez
Ez
Ez
Yn
"}
(37,1,1) = {"
Yn
Ez
Ez
Ez
cy
cy
Ez
Ez
Ez
Ez
cy
lv
dk
Uo
La
cv
cv
cv
bJ
Dm
Al
Al
pk
bu
Bt
Bt
Rj
Uo
nd
gq
Ez
Ez
BR
Bt
PK
Ez
Ez
Ez
Ez
Yn
"}
(38,1,1) = {"
Yn
Ez
Ez
Ez
cy
cy
Ez
Ez
Ez
Ez
cy
Mn
dk
qQ
qQ
cv
cv
cv
qQ
Gw
Gw
Gw
qQ
Jw
Cp
YD
qQ
qQ
nd
gq
Ez
Ez
Sj
Rk
UD
Ez
Ez
Ez
Ez
Yn
"}
(39,1,1) = {"
Yn
Ez
Ez
Ez
cy
cy
Ez
Ez
Ez
Ez
cy
Mn
ua
nd
qQ
Uo
Uo
Uo
qQ
Uo
fr
Uo
qQ
Uo
Uo
Uo
qQ
nd
nd
gq
Ez
Ez
Ez
Ez
Ez
Ez
Ez
Ez
Ez
Yn
"}
(40,1,1) = {"
Yn
Ez
Ez
Ez
Ez
Ez
Ez
Ez
Ez
Ez
Ez
Ez
di
ua
qQ
nd
cA
nd
qQ
Pe
im
Pe
qQ
nd
nd
nd
qQ
os
ox
Ez
Ez
Ez
Ez
Ez
Ez
Ez
Ez
Ez
Ez
Yn
"}
(41,1,1) = {"
Yn
Ez
Ez
Ez
cy
cy
Ez
Ez
Ez
Ez
Ez
Ez
Ez
gG
Ez
gG
gG
di
nd
nd
im
cA
nd
nd
ox
gG
gG
gG
Ez
Ez
Ez
Ez
Ez
Ez
Ez
Ez
Ez
Ez
Ez
Yn
"}
(42,1,1) = {"
Yn
Ez
Ez
Ez
cy
cy
Ez
cy
cy
cy
Ez
cy
cy
cy
Ez
Ez
Ez
Ez
pX
nd
VY
fx
fx
cI
Ez
Ez
Ez
Ez
Ez
Ez
Ez
Ez
Ez
Ez
Ez
Ez
Ez
Ez
Ez
Yn
"}
(43,1,1) = {"
Yn
Ez
Ez
Ez
cy
cy
Ez
cy
cy
cy
Ez
cy
cy
cy
Ez
Ez
Ez
Ez
Hi
os
nd
nd
nd
nd
gq
Ez
Ez
Ez
Ez
Ez
Ez
Ez
Ez
Ez
Ez
Ez
Ez
Ez
Ez
Yn
"}
(44,1,1) = {"
Yn
Ez
Ez
Ez
Ez
Ez
Ez
Ez
Ez
Ez
Ez
Ez
Ez
Ez
Ez
Ez
Ez
Ez
Ez
gG
gG
gG
gG
gG
Ez
Ez
Ez
Ez
Ez
Ez
Ez
Ez
Ez
Ez
Ez
Ez
Ez
Ez
Ez
Yn
"}
(45,1,1) = {"
Yn
Yn
Ez
Ez
Ez
Ez
Ez
Ez
Ez
Ez
Ez
Ez
Ez
Ez
Ez
Ez
Ez
Ez
Ez
Ez
Ez
Ez
Ez
Ez
Ez
Ez
Ez
Ez
Ez
Ez
Ez
Ez
Ez
Ez
Ez
Ez
Ez
Ez
Ez
Yn
"}
(46,1,1) = {"
Yn
Yn
Yn
Ez
Ez
Ez
Ez
Ez
Ez
Ez
Ez
Ez
Ez
Ez
Ez
Ez
Ez
Ez
Ez
Ez
Ez
Ez
Ez
Ez
Ez
Ez
Ez
Ez
Ez
Ez
Ez
Ez
Ez
Ez
Ez
Ez
Ez
Yn
Yn
Yn
"}
