//MAP CONVERTED BY dmm2tgm.py THIS HEADER COMMENT PREVENTS RECONVERSION, DO NOT REMOVE
"a" = (
/turf/template_noop,
/area/template_noop)
"r" = (
/obj/machinery/hydroponics/constructable,
/turf/open/floor/grass,
/area/station/service/hydroponics/garden)

(1,1,1) = {"
a
a
a
a
a
a
"}
(2,1,1) = {"
a
a
r
a
r
a
"}
(3,1,1) = {"
a
a
r
a
r
a
"}
(4,1,1) = {"
a
a
r
a
r
a
"}
(5,1,1) = {"
a
a
a
a
a
a
"}
