//MAP CONVERTED BY dmm2tgm.py THIS HEADER COMMENT PREVENTS RECONVERSION, DO NOT REMOVE
"a" = (
/obj/machinery/atmospherics/components/unary/vent_pump/on/layer4{
	dir = 8
	},
/obj/effect/turf_decal/stripes/line{
	dir = 1
	},
/obj/effect/turf_decal/tile/blue/half/contrasted{
	dir = 1
	},
/obj/effect/turf_decal/tile/neutral{
	dir = 1
	},
/obj/structure/cable,
/turf/open/floor/iron,
/area/station/command/teleporter)
"b" = (
/obj/machinery/atmospherics/pipe/smart/manifold4w/supply/hidden/layer4,
/obj/machinery/atmospherics/pipe/smart/manifold4w/scrubbers/hidden/layer2,
/obj/effect/turf_decal/tile/neutral/opposingcorners,
/obj/structure/cable,
/turf/open/floor/iron/dark,
/area/station/command/bridge)
"u" = (
/obj/machinery/atmospherics/pipe/smart/manifold4w/supply/hidden/layer4,
/obj/machinery/atmospherics/pipe/smart/manifold4w/scrubbers/hidden/layer2,
/obj/effect/turf_decal/tile/blue{
	dir = 4
	},
/obj/effect/turf_decal/tile/neutral,
/obj/structure/cable,
/turf/open/floor/iron/dark,
/area/station/command/bridge)
"G" = (
/obj/machinery/atmospherics/pipe/smart/manifold4w/scrubbers/hidden/layer2,
/obj/machinery/atmospherics/pipe/smart/manifold4w/supply/hidden/layer4,
/obj/effect/turf_decal/stripes/line{
	dir = 9
	},
/obj/effect/turf_decal/tile/blue/anticorner/contrasted{
	dir = 1
	},
/obj/effect/turf_decal/tile/neutral{
	dir = 1
	},
/obj/structure/cable,
/turf/open/floor/iron,
/area/station/command/teleporter)
"T" = (
/obj/machinery/atmospherics/pipe/smart/manifold4w/scrubbers/hidden/layer2,
/obj/machinery/atmospherics/pipe/smart/manifold4w/supply/hidden/layer4,
/obj/effect/turf_decal/tile/neutral/half/contrasted{
	dir = 4
	},
/obj/structure/cable,
/turf/open/floor/iron/dark,
/area/station/command/teleporter)
"Y" = (
/obj/machinery/atmospherics/pipe/smart/manifold4w/supply/hidden/layer4,
/obj/machinery/atmospherics/pipe/smart/manifold4w/scrubbers/hidden/layer2,
/obj/machinery/door/firedoor,
/obj/machinery/door/airlock/command{
	name = "Teleporter Access"
	},
/obj/effect/mapping_helpers/airlock/access/all/command/teleporter,
/obj/structure/cable,
/turf/open/floor/iron/dark,
/area/station/command/teleporter)

(1,1,1) = {"
b
"}
(2,1,1) = {"
u
"}
(3,1,1) = {"
Y
"}
(4,1,1) = {"
T
"}
(5,1,1) = {"
G
"}
(6,1,1) = {"
a
"}
