//MAP CONVERTED BY dmm2tgm.py THIS HEADER COMMENT PREVENTS RECONVERSION, DO NOT REMOVE
"a" = (
/obj/machinery/atmospherics/components/unary/delam_scram/directional/north,
/turf/template_noop,
/area/template_noop)
"j" = (
/obj/machinery/button/delam_scram,
/turf/template_noop,
/area/template_noop)
"q" = (
/obj/structure/sign/delam_procedure,
/turf/closed/wall/r_wall/rust,
/area/station/engineering/supermatter/engine)
"y" = (
/turf/template_noop,
/area/template_noop)

(1,1,1) = {"
y
y
y
y
a
"}
(2,1,1) = {"
y
j
q
y
y
"}
