//MAP CONVERTED BY dmm2tgm.py THIS HEADER COMMENT PREVENTS RECONVERSION, DO NOT REMOVE
"a" = (
/turf/closed/wall,
/area/station/hallway/primary/aft)
"d" = (
/obj/machinery/atmospherics/pipe/smart/manifold4w/supply/hidden/layer4,
/obj/machinery/atmospherics/components/unary/vent_scrubber/on/layer2,
/obj/structure/cable,
/turf/open/floor/iron,
/area/station/common/cryopods)
"e" = (
/obj/machinery/atmospherics/pipe/smart/manifold4w/supply/hidden/layer4,
/obj/machinery/atmospherics/pipe/smart/manifold4w/scrubbers/hidden/layer2,
/obj/structure/cable,
/turf/open/floor/iron,
/area/station/common/cryopods)
"i" = (
/obj/machinery/cryopod{
	dir = 4
	},
/obj/effect/turf_decal/siding/white{
	dir = 5
	},
/obj/machinery/light/directional/west,
/turf/open/floor/iron/dark,
/area/station/common/cryopods)
"p" = (
/obj/effect/turf_decal/stripes/corner,
/obj/effect/decal/cleanable/dirt,
/obj/structure/cable,
/obj/machinery/power/apc/auto_name/directional/west,
/turf/open/floor/plating,
/area/station/hallway/primary/aft)
"t" = (
/obj/machinery/cryopod{
	dir = 8
	},
/obj/effect/turf_decal/siding/white{
	dir = 9
	},
/turf/open/floor/iron/dark,
/area/station/common/cryopods)
"v" = (
/obj/machinery/computer/cryopod/directional/north,
/turf/open/floor/iron,
/area/station/common/cryopods)
"D" = (
/turf/closed/wall,
/area/station/common/cryopods)
"E" = (
/obj/machinery/atmospherics/pipe/smart/manifold4w/supply/hidden/layer4,
/obj/effect/decal/cleanable/dirt,
/obj/effect/mapping_helpers/burnt_floor,
/obj/machinery/atmospherics/pipe/smart/manifold4w/scrubbers/hidden/layer2,
/obj/structure/cable,
/turf/open/floor/plating,
/area/station/hallway/primary/aft)
"G" = (
/obj/machinery/door/airlock/maintenance,
/obj/machinery/atmospherics/pipe/smart/manifold4w/supply/hidden/layer4,
/obj/effect/mapping_helpers/airlock/unres/delayed,
/obj/effect/mapping_helpers/airlock/access/any/security/maintenance,
/obj/machinery/atmospherics/pipe/smart/manifold4w/scrubbers/hidden/layer2,
/obj/structure/cable,
/turf/open/floor/iron/dark,
/area/station/hallway/primary/aft)
"H" = (
/obj/machinery/atmospherics/components/unary/vent_pump/on/layer4,
/obj/structure/cable,
/turf/open/floor/iron,
/area/station/common/cryopods)
"J" = (
/obj/structure/grille/broken,
/obj/effect/turf_decal/stripes/line,
/obj/machinery/atmospherics/pipe/smart/manifold4w/supply/hidden/layer4,
/obj/effect/decal/cleanable/dirt,
/obj/structure/cable,
/obj/effect/mapping_helpers/broken_floor,
/obj/machinery/atmospherics/pipe/smart/manifold4w/scrubbers/hidden/layer2,
/turf/open/floor/plating,
/area/station/hallway/primary/aft)
"K" = (
/obj/effect/spawner/random/decoration/glowstick,
/obj/machinery/atmospherics/components/unary/vent_pump/on/layer4{
	dir = 4
	},
/obj/effect/decal/cleanable/dirt,
/obj/structure/sign/poster/contraband/random/directional/north,
/obj/effect/mapping_helpers/broken_floor,
/turf/open/floor/plating,
/area/station/hallway/primary/aft)
"P" = (
/obj/machinery/door/airlock/engineering{
	name = "Emergency Storage"
	},
/obj/machinery/atmospherics/pipe/smart/manifold4w/supply/hidden/layer4,
/obj/structure/cable,
/obj/effect/mapping_helpers/airlock/unres/delayed{
	dir = 1
	},
/obj/effect/mapping_helpers/airlock/access/all/engineering/maintenance,
/obj/machinery/atmospherics/pipe/smart/manifold4w/scrubbers/hidden/layer2,
/turf/open/floor/iron/dark,
/area/station/hallway/primary/aft)
"R" = (
/obj/machinery/cryopod{
	dir = 4
	},
/obj/effect/turf_decal/siding/white{
	dir = 4
	},
/turf/open/floor/iron/dark,
/area/station/common/cryopods)
"S" = (
/obj/effect/turf_decal/delivery,
/obj/effect/decal/cleanable/dirt,
/obj/structure/closet/firecloset,
/obj/effect/turf_decal/tile/neutral/half/contrasted{
	dir = 8
	},
/turf/open/floor/iron/dark,
/area/station/hallway/primary/aft)
"T" = (
/turf/closed/wall/rust,
/area/station/hallway/primary/aft)
"U" = (
/obj/structure/rack,
/obj/effect/turf_decal/bot,
/obj/item/storage/toolbox/emergency,
/obj/item/flashlight,
/obj/machinery/light/small/directional/east,
/obj/effect/turf_decal/stripes/corner{
	dir = 8
	},
/turf/open/floor/iron/dark,
/area/station/hallway/primary/aft)
"V" = (
/obj/effect/spawner/structure/window/reinforced,
/turf/open/floor/plating,
/area/station/common/cryopods)
"W" = (
/obj/machinery/power/apc/auto_name/directional/west,
/obj/structure/cable,
/turf/open/floor/iron,
/area/station/common/cryopods)
"X" = (
/obj/machinery/door/airlock/public/glass{
	name = "Cryopods"
	},
/obj/machinery/door/firedoor,
/turf/open/floor/iron/dark,
/area/station/common/cryopods)
"Y" = (
/obj/machinery/cryopod{
	dir = 8
	},
/obj/effect/turf_decal/siding/white{
	dir = 8
	},
/obj/machinery/camera/directional/south,
/obj/machinery/firealarm/directional/east,
/turf/open/floor/iron/dark,
/area/station/common/cryopods)

(1,1,1) = {"
X
W
i
R
a
K
p
a
"}
(2,1,1) = {"
V
H
d
e
G
E
J
P
"}
(3,1,1) = {"
D
v
t
Y
T
S
U
a
"}
(4,1,1) = {"
D
V
V
D
a
a
a
a
"}
