//MAP CONVERTED BY dmm2tgm.py THIS HEADER COMMENT PREVENTS RECONVERSION, DO NOT REMOVE
"a" = (
/turf/closed/wall/r_wall,
/area/station/command/heads_quarters/nt_rep)
"b" = (
/obj/structure/cable,
/obj/structure/disposalpipe/segment{
	dir = 10
	},
/obj/machinery/atmospherics/pipe/smart/manifold4w/supply/hidden/layer4,
/obj/machinery/atmospherics/pipe/smart/manifold4w/scrubbers/hidden/layer2,
/turf/open/floor/wood,
/area/station/command/heads_quarters/nt_rep)
"c" = (
/obj/structure/cable,
/obj/structure/disposalpipe/segment,
/obj/machinery/power/apc/auto_name/directional/west,
/turf/open/floor/wood,
/area/station/command/heads_quarters/nt_rep)
"g" = (
/obj/structure/chair/office{
	dir = 8
	},
/obj/effect/landmark/start/nanotrasen_consultant,
/obj/machinery/firealarm/directional/north,
/turf/open/floor/carpet/executive,
/area/station/command/heads_quarters/nt_rep)
"j" = (
/obj/machinery/atmospherics/components/unary/vent_pump/on/layer4,
/turf/open/floor/carpet/executive,
/area/station/command/heads_quarters/nt_rep)
"m" = (
/obj/structure/table/wood,
/obj/machinery/light/directional/north,
/obj/item/folder/red{
	pixel_x = -4;
	pixel_y = -2
	},
/obj/item/stamp/granted{
	pixel_x = -2;
	pixel_y = 6
	},
/obj/item/stamp/denied{
	pixel_x = 8;
	pixel_y = 6
	},
/turf/open/floor/carpet/executive,
/area/station/command/heads_quarters/nt_rep)
"o" = (
/obj/machinery/atmospherics/pipe/smart/manifold4w/supply/hidden/layer4,
/obj/machinery/atmospherics/components/unary/vent_scrubber/on/layer2{
	dir = 8
	},
/obj/machinery/light_switch/directional/east,
/turf/open/floor/wood,
/area/station/command/heads_quarters/nt_rep)
"p" = (
/obj/structure/table/wood,
/obj/item/paper_bin{
	pixel_y = 4
	},
/obj/item/pen/fountain,
/turf/open/floor/carpet/executive,
/area/station/command/heads_quarters/nt_rep)
"r" = (
/obj/structure/closet/secure_closet/nanotrasen_consultant,
/turf/open/floor/carpet/executive,
/area/station/command/heads_quarters/nt_rep)
"s" = (
/obj/structure/chair/office{
	dir = 4
	},
/obj/machinery/airalarm/directional/north,
/turf/open/floor/wood,
/area/station/command/heads_quarters/nt_rep)
"u" = (
/obj/structure/cable,
/obj/structure/disposalpipe/segment{
	dir = 4
	},
/turf/open/floor/wood,
/area/station/command/heads_quarters/nt_rep)
"v" = (
/obj/machinery/atmospherics/pipe/smart/manifold4w/supply/hidden/layer4,
/obj/machinery/atmospherics/pipe/smart/manifold4w/scrubbers/hidden/layer2,
/obj/structure/cable,
/obj/effect/turf_decal/stripes/line{
	dir = 1
	},
/obj/structure/disposalpipe/segment,
/obj/effect/turf_decal/tile/neutral/half/contrasted{
	dir = 1
	},
/turf/open/floor/iron/dark/corner{
	dir = 1
	},
/area/station/hallway/primary/central)
"w" = (
/obj/structure/disposalpipe/segment,
/obj/machinery/light/directional/west,
/turf/open/floor/wood,
/area/station/command/heads_quarters/nt_rep)
"y" = (
/obj/structure/disposalpipe/segment,
/turf/closed/wall/r_wall,
/area/station/command/heads_quarters/captain)
"A" = (
/obj/structure/disposalpipe/segment,
/obj/machinery/fax/heads/nanotrasen_consultant,
/obj/structure/table/wood,
/turf/open/floor/wood,
/area/station/command/heads_quarters/nt_rep)
"C" = (
/obj/effect/spawner/structure/window/reinforced,
/obj/machinery/door/poddoor/preopen{
	id = "nt_rep_priv";
	name = "Privacy Shutter"
	},
/turf/open/floor/plating,
/area/station/command/heads_quarters/nt_rep)
"E" = (
/turf/template_noop,
/area/template_noop)
"F" = (
/obj/item/kirbyplants/organic/plant16,
/obj/effect/turf_decal/tile/neutral/anticorner/contrasted{
	dir = 1
	},
/turf/open/floor/iron/dark/corner{
	dir = 1
	},
/area/station/hallway/primary/central)
"G" = (
/obj/machinery/atmospherics/pipe/smart/manifold4w/supply/hidden/layer4,
/obj/machinery/atmospherics/pipe/smart/manifold4w/scrubbers/hidden/layer2,
/obj/effect/turf_decal/stripes/corner{
	dir = 1
	},
/obj/machinery/airalarm/directional/north,
/obj/effect/turf_decal/tile/neutral/half/contrasted{
	dir = 1
	},
/turf/open/floor/iron/dark/corner{
	dir = 1
	},
/area/station/hallway/primary/central)
"H" = (
/turf/open/floor/wood,
/area/station/command/heads_quarters/nt_rep)
"I" = (
/obj/machinery/atmospherics/pipe/smart/manifold4w/supply/hidden/layer4,
/obj/machinery/atmospherics/pipe/smart/manifold4w/scrubbers/hidden/layer2,
/obj/effect/turf_decal/stripes/corner{
	dir = 4
	},
/obj/effect/turf_decal/tile/neutral/anticorner/contrasted{
	dir = 1
	},
/turf/open/floor/iron/dark/corner{
	dir = 1
	},
/area/station/hallway/primary/central)
"J" = (
/obj/machinery/airalarm/directional/east,
/obj/machinery/modular_computer/preset/command{
	dir = 8
	},
/turf/open/floor/carpet/executive,
/area/station/command/heads_quarters/nt_rep)
"M" = (
/obj/machinery/door/airlock/corporate{
	name = "NT Consultant's Office"
	},
/obj/structure/cable,
/obj/machinery/atmospherics/pipe/smart/manifold4w/scrubbers/hidden/layer2,
/obj/effect/mapping_helpers/airlock/access/all/cent_com/rep_door,
/obj/machinery/door/firedoor,
/obj/machinery/atmospherics/pipe/smart/manifold4w/supply/hidden/layer4,
/turf/open/floor/iron,
/area/station/command/heads_quarters/nt_rep)
"O" = (
/obj/machinery/atmospherics/pipe/smart/manifold4w/supply/hidden/layer4,
/obj/machinery/atmospherics/pipe/smart/manifold4w/scrubbers/hidden/layer2,
/turf/open/floor/iron,
/area/station/hallway/primary/central)
"U" = (
/obj/structure/cable,
/obj/structure/disposalpipe/segment{
	dir = 5
	},
/obj/machinery/button/door/directional/west{
	id = "nt_rep_priv";
	name = "Privacy Shutters Control";
	pixel_y = 8
	},
/obj/machinery/photocopier/prebuilt,
/turf/open/floor/wood,
/area/station/command/heads_quarters/nt_rep)

(1,1,1) = {"
E
a
a
a
a
a
a
E
"}
(2,1,1) = {"
y
A
w
c
U
C
F
O
"}
(3,1,1) = {"
E
a
s
H
u
C
I
E
"}
(4,1,1) = {"
E
a
m
p
b
M
v
E
"}
(5,1,1) = {"
E
a
g
j
o
a
G
E
"}
(6,1,1) = {"
E
a
r
J
a
a
E
E
"}
(7,1,1) = {"
E
a
C
a
a
E
E
E
"}
