//MAP CONVERTED BY dmm2tgm.py THIS HEADER COMMENT PREVENTS RECONVERSION, DO NOT REMOVE
"aB" = (
/obj/structure/table/glass,
/obj/structure/mirror/directional/east,
/obj/item/hairbrush/comb{
	pixel_y = 10
	},
/obj/item/reagent_containers/dropper,
/turf/open/floor/iron/dark/pattern_6,
/area/station/service/barber)
"bF" = (
/obj/structure/curtain/cloth,
/turf/open/floor/plating,
/area/station/maintenance/fore)
"cx" = (
/obj/effect/decal/cleanable/dirt,
/obj/machinery/atmospherics/pipe/smart/manifold4w/supply/hidden/layer4,
/obj/machinery/atmospherics/pipe/smart/manifold4w/scrubbers/hidden/layer2,
/obj/structure/cable,
/obj/effect/mapping_helpers/broken_floor,
/turf/open/floor/plating,
/area/station/maintenance/fore)
"cO" = (
/obj/effect/decal/cleanable/dirt,
/obj/effect/spawner/random/structure/steam_vent,
/turf/open/floor/plating,
/area/station/maintenance/fore)
"df" = (
/obj/structure/chair/stool{
	dir = 4
	},
/obj/effect/decal/cleanable/cobweb,
/obj/effect/decal/cleanable/dirt,
/turf/open/floor/iron/dark,
/area/station/maintenance/fore)
"do" = (
/obj/effect/turf_decal/tile/neutral/anticorner/contrasted{
	dir = 4
	},
/obj/machinery/atmospherics/pipe/smart/manifold4w/supply/hidden/layer4,
/obj/machinery/atmospherics/pipe/smart/manifold4w/scrubbers/hidden/layer2,
/turf/open/floor/iron/dark/corner{
	dir = 4
	},
/area/station/hallway/primary/fore)
"dS" = (
/obj/effect/decal/cleanable/dirt,
/obj/effect/mapping_helpers/burnt_floor,
/turf/open/floor/plating,
/area/station/maintenance/fore)
"dV" = (
/obj/effect/decal/cleanable/dirt,
/obj/machinery/atmospherics/pipe/smart/manifold4w/scrubbers/hidden/layer2,
/obj/machinery/atmospherics/pipe/smart/manifold4w/supply/hidden/layer4,
/obj/structure/cable,
/turf/open/floor/plating,
/area/station/maintenance/fore)
"dZ" = (
/obj/effect/turf_decal/tile/neutral/half/contrasted{
	dir = 1
	},
/obj/item/kirbyplants/random,
/turf/open/floor/iron/dark/corner{
	dir = 4
	},
/area/station/hallway/primary/fore)
"hl" = (
/obj/effect/mapping_helpers/broken_floor,
/turf/open/floor/plating,
/area/station/maintenance/fore)
"hF" = (
/obj/machinery/atmospherics/pipe/smart/manifold4w/supply/hidden/layer4,
/obj/machinery/atmospherics/pipe/smart/manifold4w/scrubbers/hidden/layer2,
/obj/effect/decal/cleanable/dirt,
/obj/structure/cable,
/obj/effect/turf_decal/stripes/corner{
	dir = 4
	},
/obj/effect/mapping_helpers/broken_floor,
/turf/open/floor/plating,
/area/station/maintenance/fore)
"hH" = (
/obj/machinery/atmospherics/pipe/smart/manifold4w/scrubbers/hidden/layer2,
/obj/machinery/atmospherics/pipe/smart/manifold4w/supply/hidden/layer4,
/obj/structure/cable,
/obj/effect/turf_decal/tile/neutral/fourcorners,
/turf/open/floor/iron,
/area/station/hallway/primary/fore)
"js" = (
/obj/effect/decal/cleanable/dirt,
/obj/effect/decal/cleanable/blood/old,
/obj/effect/decal/cleanable/dirt,
/turf/open/floor/plating,
/area/station/maintenance/fore)
"jP" = (
/obj/effect/turf_decal/siding/wood{
	dir = 4
	},
/obj/machinery/atmospherics/pipe/smart/manifold4w/scrubbers/hidden/layer2,
/obj/machinery/atmospherics/components/unary/vent_pump/on/layer4,
/turf/open/floor/wood/parquet,
/area/station/service/barber)
"jT" = (
/obj/effect/turf_decal/siding/wood{
	dir = 1
	},
/turf/open/floor/wood/parquet,
/area/station/service/barber)
"ka" = (
/obj/effect/decal/cleanable/dirt,
/obj/effect/turf_decal/stripes/corner{
	dir = 1
	},
/obj/machinery/light/small/directional/south,
/obj/effect/mapping_helpers/broken_floor,
/turf/open/floor/plating,
/area/station/maintenance/fore)
"kD" = (
/obj/machinery/atmospherics/pipe/smart/manifold4w/supply/hidden/layer4,
/obj/machinery/atmospherics/pipe/smart/manifold4w/scrubbers/hidden/layer2,
/obj/structure/cable,
/turf/open/floor/plating,
/area/station/maintenance/fore)
"kE" = (
/obj/structure/chair/comfy/barber_chair{
	dir = 4
	},
/obj/machinery/newscaster/directional/north,
/turf/open/floor/iron/dark/pattern_6,
/area/station/service/barber)
"kV" = (
/obj/effect/decal/cleanable/dirt,
/obj/effect/decal/cleanable/blood/old,
/obj/effect/turf_decal/stripes/line{
	dir = 1
	},
/obj/machinery/atmospherics/pipe/smart/manifold4w/supply/hidden/layer4,
/obj/structure/cable,
/obj/structure/sign/warning/electric_shock/directional/west{
	pixel_y = -32
	},
/obj/machinery/atmospherics/pipe/smart/manifold4w/scrubbers/hidden/layer2,
/turf/open/floor/plating,
/area/station/maintenance/fore)
"lh" = (
/obj/item/radio/intercom/directional/east,
/obj/effect/turf_decal/tile/neutral/half/contrasted{
	dir = 4
	},
/obj/machinery/atmospherics/pipe/smart/manifold4w/supply/hidden/layer4,
/obj/machinery/atmospherics/pipe/smart/manifold4w/scrubbers/hidden/layer2,
/turf/open/floor/iron/dark/corner{
	dir = 4
	},
/area/station/hallway/primary/fore)
"mr" = (
/obj/effect/turf_decal/tile/neutral/fourcorners,
/obj/machinery/atmospherics/pipe/smart/manifold4w/scrubbers/hidden/layer2,
/obj/structure/disposalpipe/segment{
	dir = 10
	},
/obj/machinery/atmospherics/pipe/smart/manifold4w/supply/hidden/layer4,
/turf/open/floor/iron,
/area/station/hallway/primary/fore)
"mC" = (
/obj/effect/turf_decal/tile/neutral/fourcorners,
/turf/open/floor/iron,
/area/station/hallway/primary/fore)
"ny" = (
/obj/machinery/airalarm/directional/north,
/obj/machinery/light/directional/north,
/turf/open/floor/iron/dark/pattern_6,
/area/station/service/barber)
"nX" = (
/obj/effect/decal/cleanable/dirt,
/obj/machinery/atmospherics/pipe/smart/manifold4w/supply/hidden/layer4,
/obj/machinery/atmospherics/pipe/smart/manifold4w/scrubbers/hidden/layer2,
/obj/structure/cable,
/obj/effect/mapping_helpers/burnt_floor,
/turf/open/floor/plating,
/area/station/maintenance/fore)
"oc" = (
/obj/machinery/vending/autodrobe,
/turf/open/floor/iron/dark/pattern_6,
/area/station/service/barber)
"or" = (
/obj/machinery/door/airlock/maintenance,
/turf/open/floor/iron/dark,
/area/station/maintenance/fore)
"oA" = (
/obj/effect/decal/cleanable/blood/old,
/turf/open/floor/plating,
/area/station/maintenance/fore)
"oM" = (
/turf/closed/wall,
/area/station/maintenance/fore)
"pi" = (
/obj/effect/mapping_helpers/broken_floor,
/obj/effect/decal/cleanable/dirt,
/obj/structure/sign/poster/contraband/random/directional/north,
/turf/open/floor/plating,
/area/station/maintenance/fore)
"pz" = (
/obj/structure/bed{
	dir = 4
	},
/turf/open/floor/iron/dark,
/area/station/maintenance/fore)
"pR" = (
/obj/effect/decal/cleanable/dirt,
/turf/open/floor/iron/dark,
/area/station/maintenance/fore)
"qu" = (
/obj/machinery/atmospherics/components/unary/vent_pump/on/layer4,
/obj/effect/turf_decal/tile/neutral/fourcorners,
/turf/open/floor/iron,
/area/station/hallway/primary/fore)
"ry" = (
/obj/structure/cable,
/obj/machinery/atmospherics/pipe/smart/manifold4w/scrubbers/hidden/layer2,
/obj/structure/disposalpipe/segment,
/obj/machinery/atmospherics/pipe/smart/manifold4w/supply/hidden/layer4,
/obj/effect/turf_decal/tile/neutral/fourcorners,
/turf/open/floor/iron,
/area/station/hallway/primary/fore)
"rA" = (
/obj/effect/turf_decal/tile/neutral/half/contrasted{
	dir = 1
	},
/obj/machinery/wall_healer/directional/north,
/turf/open/floor/iron/dark/corner{
	dir = 4
	},
/area/station/hallway/primary/fore)
"rD" = (
/turf/open/floor/plating,
/area/station/maintenance/fore)
"rV" = (
/obj/structure/grille/broken,
/turf/open/floor/plating,
/area/station/maintenance/fore)
"tq" = (
/obj/structure/extinguisher_cabinet/directional/north,
/obj/effect/turf_decal/tile/neutral/half/contrasted{
	dir = 1
	},
/turf/open/floor/iron/dark/corner{
	dir = 4
	},
/area/station/hallway/primary/fore)
"ub" = (
/obj/effect/turf_decal/bot,
/obj/effect/decal/cleanable/dirt,
/obj/structure/reagent_dispensers/fueltank,
/obj/effect/decal/cleanable/cobweb,
/turf/open/floor/plating,
/area/station/maintenance/fore)
"vS" = (
/obj/effect/turf_decal/siding/wood{
	dir = 4
	},
/obj/machinery/atmospherics/pipe/smart/manifold4w/scrubbers/hidden/layer2,
/turf/open/floor/wood/parquet,
/area/station/service/barber)
"wI" = (
/turf/closed/wall,
/area/station/service/barber)
"xs" = (
/obj/effect/decal/cleanable/dirt,
/obj/effect/turf_decal/stripes/line{
	dir = 1
	},
/obj/effect/mapping_helpers/burnt_floor,
/turf/open/floor/plating,
/area/station/maintenance/fore)
"xw" = (
/obj/effect/decal/cleanable/dirt,
/obj/effect/mapping_helpers/broken_floor,
/obj/effect/decal/cleanable/blood/old,
/turf/open/floor/plating,
/area/station/maintenance/fore)
"xL" = (
/obj/structure/table/glass,
/obj/item/razor{
	pixel_x = -6
	},
/obj/item/reagent_containers/spray/barbers_aid{
	pixel_x = 6
	},
/obj/machinery/computer/security/telescreen/entertainment/directional/east,
/turf/open/floor/iron/dark/pattern_6,
/area/station/service/barber)
"yc" = (
/obj/machinery/light_switch/directional/south,
/obj/machinery/atmospherics/pipe/smart/manifold4w/supply/hidden/layer4,
/obj/machinery/atmospherics/pipe/smart/manifold4w/scrubbers/hidden/layer2,
/turf/open/floor/wood/parquet,
/area/station/service/barber)
"yI" = (
/obj/machinery/vending/clothing,
/obj/machinery/digital_clock/directional/south,
/turf/open/floor/iron/dark/pattern_6,
/area/station/service/barber)
"zc" = (
/obj/effect/turf_decal/tile/neutral{
	dir = 4
	},
/turf/template_noop,
/area/template_noop)
"Bo" = (
/turf/open/floor/iron/dark/pattern_6,
/area/station/service/barber)
"BC" = (
/obj/machinery/firealarm/directional/south,
/obj/effect/turf_decal/siding/wood{
	dir = 4
	},
/obj/machinery/atmospherics/pipe/smart/manifold4w/supply/hidden/layer4,
/obj/machinery/atmospherics/pipe/smart/manifold4w/scrubbers/hidden/layer2,
/obj/machinery/light/directional/south,
/turf/open/floor/wood/parquet,
/area/station/service/barber)
"Cf" = (
/turf/closed/wall/rust,
/area/station/maintenance/fore)
"DF" = (
/obj/machinery/door/airlock/maintenance,
/turf/open/floor/iron/dark/pattern_6,
/area/station/service/barber)
"EA" = (
/obj/effect/decal/cleanable/dirt,
/turf/open/floor/plating,
/area/station/maintenance/fore)
"FZ" = (
/turf/open/floor/iron/dark,
/area/station/maintenance/fore)
"GR" = (
/obj/effect/spawner/structure/window/reinforced,
/turf/open/floor/plating,
/area/station/service/barber)
"Hw" = (
/obj/structure/sink/directional/east,
/turf/open/floor/wood/parquet,
/area/station/service/barber)
"Ih" = (
/obj/structure/chair/stool{
	dir = 4
	},
/turf/open/floor/iron/dark,
/area/station/maintenance/fore)
"MH" = (
/obj/machinery/vending/barbervend,
/turf/open/floor/wood/parquet,
/area/station/service/barber)
"NQ" = (
/obj/machinery/modular_computer/preset/civilian,
/turf/open/floor/iron/dark/pattern_6,
/area/station/service/barber)
"OC" = (
/obj/machinery/atmospherics/pipe/smart/manifold4w/scrubbers/hidden/layer2,
/obj/machinery/atmospherics/pipe/smart/manifold4w/supply/hidden/layer4,
/obj/structure/cable,
/obj/effect/turf_decal/tile/neutral/half/contrasted{
	dir = 4
	},
/turf/open/floor/iron/dark/corner{
	dir = 4
	},
/area/station/hallway/primary/fore)
"Pd" = (
/obj/effect/mapping_helpers/broken_floor,
/obj/effect/decal/cleanable/blood/old,
/turf/open/floor/plating,
/area/station/maintenance/fore)
"PA" = (
/obj/machinery/door/airlock/maintenance,
/obj/machinery/atmospherics/pipe/smart/manifold4w/scrubbers/hidden/layer2,
/obj/machinery/atmospherics/pipe/smart/manifold4w/supply/hidden/layer4,
/obj/structure/cable,
/obj/effect/mapping_helpers/airlock/unres/delayed{
	dir = 4
	},
/obj/effect/mapping_helpers/airlock/access/all/engineering/maintenance,
/turf/open/floor/iron/dark,
/area/station/maintenance/fore)
"PI" = (
/obj/structure/closet/secure_closet/barber,
/turf/open/floor/iron/dark/pattern_6,
/area/station/service/barber)
"PR" = (
/obj/machinery/door/airlock/public/glass{
	name = "Barbershop"
	},
/obj/machinery/atmospherics/pipe/smart/manifold4w/supply/hidden/layer4,
/obj/machinery/atmospherics/pipe/smart/manifold4w/scrubbers/hidden/layer2,
/turf/open/floor/wood/parquet,
/area/station/service/barber)
"QR" = (
/obj/structure/table/glass,
/obj/structure/mirror/directional/east,
/obj/item/hairbrush,
/turf/open/floor/iron/dark/pattern_6,
/area/station/service/barber)
"QT" = (
/obj/machinery/door/airlock/maintenance,
/obj/machinery/atmospherics/pipe/smart/manifold4w/supply/hidden/layer4,
/obj/machinery/atmospherics/pipe/smart/manifold4w/scrubbers/hidden/layer2,
/obj/structure/cable,
/obj/effect/mapping_helpers/airlock/unres/delayed{
	dir = 4
	},
/obj/effect/mapping_helpers/airlock/access/any/service/maintenance,
/turf/open/floor/iron/dark,
/area/station/maintenance/fore)
"Tg" = (
/obj/structure/chair/office{
	dir = 4
	},
/obj/machinery/power/apc/auto_name/directional/west,
/obj/effect/turf_decal/siding/wood{
	dir = 1
	},
/turf/open/floor/wood/parquet,
/area/station/service/barber)
"UQ" = (
/obj/structure/chair/comfy/barber_chair{
	dir = 4
	},
/turf/open/floor/iron/dark/pattern_6,
/area/station/service/barber)
"Wp" = (
/obj/effect/turf_decal/siding/wood{
	dir = 5
	},
/obj/machinery/atmospherics/components/unary/vent_scrubber/on/layer2,
/turf/open/floor/wood/parquet,
/area/station/service/barber)
"WS" = (
/obj/machinery/light/small/directional/east,
/obj/structure/table/glass,
/obj/structure/towel_bin,
/obj/structure/sign/poster/contraband/lusty_xenomorph/directional/east,
/turf/open/floor/iron/dark,
/area/station/maintenance/fore)
"WY" = (
/obj/effect/decal/cleanable/dirt,
/obj/effect/decal/cleanable/blood/old,
/turf/open/floor/plating,
/area/station/maintenance/fore)

(1,1,1) = {"
Cf
Cf
Cf
ub
xw
Cf
rA
mC
mr
ry
"}
(2,1,1) = {"
Cf
rD
EA
Pd
oA
Cf
tq
mC
qu
hH
"}
(3,1,1) = {"
oM
pi
wI
wI
wI
wI
dZ
do
lh
OC
"}
(4,1,1) = {"
oM
EA
wI
NQ
Tg
wI
GR
PR
wI
PA
"}
(5,1,1) = {"
Cf
cO
wI
PI
jT
MH
Hw
yc
wI
dV
"}
(6,1,1) = {"
oM
WY
wI
ny
Wp
vS
jP
BC
wI
kD
"}
(7,1,1) = {"
Cf
EA
wI
kE
Bo
UQ
Bo
yI
wI
cx
"}
(8,1,1) = {"
oM
hl
wI
aB
xL
QR
Bo
oc
wI
nX
"}
(9,1,1) = {"
Cf
rV
wI
wI
wI
wI
DF
wI
wI
QT
"}
(10,1,1) = {"
Cf
EA
EA
hl
js
bF
FZ
bF
rD
hF
"}
(11,1,1) = {"
oM
oM
oM
oM
oM
oM
or
oM
oM
kV
"}
(12,1,1) = {"
zc
zc
zc
zc
Cf
df
pR
Ih
oM
xs
"}
(13,1,1) = {"
zc
zc
zc
zc
oM
pz
WS
pz
oM
ka
"}
(14,1,1) = {"
zc
zc
zc
zc
Cf
oM
oM
Cf
oM
dS
"}
