//MAP CONVERTED BY dmm2tgm.py THIS HEADER COMMENT PREVENTS RECONVERSION, DO NOT REMOVE
"a" = (
/obj/machinery/atmospherics/components/unary/vent_pump/on/layer4,
/turf/open/floor/carpet/executive,
/area/station/command/heads_quarters/nt_rep)
"c" = (
/turf/closed/wall/r_wall,
/area/station/command/heads_quarters/captain)
"d" = (
/obj/structure/cable,
/obj/structure/disposalpipe/segment{
	dir = 5
	},
/obj/machinery/button/door/directional/west{
	id = "nt_rep_priv";
	name = "Privacy Shutters Control";
	pixel_y = 8
	},
/obj/machinery/photocopier/prebuilt,
/turf/open/floor/wood,
/area/station/command/heads_quarters/nt_rep)
"e" = (
/obj/machinery/atmospherics/pipe/smart/manifold4w/supply/hidden/layer4,
/obj/machinery/atmospherics/pipe/smart/manifold4w/scrubbers/hidden/layer2,
/obj/structure/cable,
/obj/effect/turf_decal/stripes/line{
	dir = 1
	},
/obj/structure/disposalpipe/segment,
/obj/effect/turf_decal/tile/neutral/half/contrasted{
	dir = 1
	},
/turf/open/floor/iron/dark/corner{
	dir = 1
	},
/area/station/hallway/primary/central)
"f" = (
/obj/machinery/atmospherics/pipe/smart/manifold4w/supply/hidden/layer4,
/obj/machinery/atmospherics/pipe/smart/manifold4w/scrubbers/hidden/layer2,
/turf/open/floor/iron,
/area/station/hallway/primary/central)
"h" = (
/obj/structure/disposalpipe/segment,
/obj/machinery/fax/heads/nanotrasen_consultant,
/obj/structure/table/wood,
/turf/open/floor/wood,
/area/station/command/heads_quarters/nt_rep)
"k" = (
/turf/closed/wall/r_wall,
/area/station/command/heads_quarters/nt_rep)
"l" = (
/obj/machinery/atmospherics/pipe/smart/manifold4w/supply/hidden/layer4,
/obj/machinery/atmospherics/components/unary/vent_scrubber/on/layer2{
	dir = 8
	},
/obj/machinery/light_switch/directional/east,
/turf/open/floor/wood,
/area/station/command/heads_quarters/nt_rep)
"o" = (
/turf/open/floor/wood,
/area/station/command/heads_quarters/nt_rep)
"s" = (
/obj/structure/cable,
/obj/structure/disposalpipe/segment{
	dir = 4
	},
/turf/open/floor/wood,
/area/station/command/heads_quarters/nt_rep)
"x" = (
/obj/machinery/atmospherics/pipe/smart/manifold4w/supply/hidden/layer4,
/obj/machinery/atmospherics/pipe/smart/manifold4w/scrubbers/hidden/layer2,
/obj/effect/turf_decal/stripes/corner{
	dir = 4
	},
/obj/effect/turf_decal/tile/neutral/anticorner/contrasted{
	dir = 1
	},
/turf/open/floor/iron/dark/corner{
	dir = 1
	},
/area/station/hallway/primary/central)
"z" = (
/obj/machinery/airalarm/directional/east,
/obj/machinery/modular_computer/preset/command{
	dir = 8
	},
/turf/open/floor/carpet/executive,
/area/station/command/heads_quarters/nt_rep)
"B" = (
/obj/structure/closet/secure_closet/nanotrasen_consultant,
/turf/open/floor/carpet/executive,
/area/station/command/heads_quarters/nt_rep)
"C" = (
/obj/structure/chair/office{
	dir = 4
	},
/obj/machinery/airalarm/directional/north,
/turf/open/floor/wood,
/area/station/command/heads_quarters/nt_rep)
"G" = (
/obj/structure/table/wood,
/obj/machinery/light/directional/north,
/obj/item/folder/red{
	pixel_x = -4;
	pixel_y = -2
	},
/obj/item/stamp/granted{
	pixel_x = -2;
	pixel_y = 6
	},
/obj/item/stamp/denied{
	pixel_x = 8;
	pixel_y = 6
	},
/turf/open/floor/carpet/executive,
/area/station/command/heads_quarters/nt_rep)
"H" = (
/obj/structure/cable,
/obj/structure/disposalpipe/segment,
/obj/machinery/power/apc/auto_name/directional/west,
/turf/open/floor/wood,
/area/station/command/heads_quarters/nt_rep)
"I" = (
/obj/effect/spawner/structure/window/reinforced,
/obj/machinery/door/poddoor/preopen{
	id = "nt_rep_priv";
	name = "Privacy Shutter"
	},
/turf/open/floor/plating,
/area/station/command/heads_quarters/nt_rep)
"K" = (
/obj/structure/disposalpipe/segment,
/obj/machinery/light/directional/west,
/turf/open/floor/wood,
/area/station/command/heads_quarters/nt_rep)
"O" = (
/obj/item/kirbyplants/organic/plant16,
/obj/effect/turf_decal/tile/neutral/anticorner/contrasted{
	dir = 1
	},
/turf/open/floor/iron/dark/corner{
	dir = 1
	},
/area/station/hallway/primary/central)
"S" = (
/obj/structure/table/wood,
/obj/item/paper_bin{
	pixel_y = 4
	},
/obj/item/pen/fountain,
/turf/open/floor/carpet/executive,
/area/station/command/heads_quarters/nt_rep)
"T" = (
/obj/machinery/atmospherics/pipe/smart/manifold4w/supply/hidden/layer4,
/obj/machinery/atmospherics/pipe/smart/manifold4w/scrubbers/hidden/layer2,
/obj/effect/turf_decal/stripes/corner{
	dir = 1
	},
/obj/machinery/airalarm/directional/north,
/obj/effect/turf_decal/tile/neutral/half/contrasted{
	dir = 1
	},
/turf/open/floor/iron/dark/corner{
	dir = 1
	},
/area/station/hallway/primary/central)
"V" = (
/obj/structure/chair/office{
	dir = 8
	},
/obj/effect/landmark/start/nanotrasen_consultant,
/obj/machinery/firealarm/directional/north,
/turf/open/floor/carpet/executive,
/area/station/command/heads_quarters/nt_rep)
"W" = (
/obj/structure/cable,
/obj/structure/disposalpipe/segment{
	dir = 10
	},
/obj/machinery/atmospherics/pipe/smart/manifold4w/supply/hidden/layer4,
/obj/machinery/atmospherics/pipe/smart/manifold4w/scrubbers/hidden/layer2,
/turf/open/floor/wood,
/area/station/command/heads_quarters/nt_rep)
"X" = (
/turf/template_noop,
/area/template_noop)
"Y" = (
/obj/machinery/door/airlock/corporate{
	name = "NT Consultant's Office"
	},
/obj/structure/cable,
/obj/machinery/atmospherics/pipe/smart/manifold4w/scrubbers/hidden/layer2,
/obj/effect/mapping_helpers/airlock/access/all/cent_com/rep_door,
/obj/machinery/door/firedoor,
/obj/machinery/atmospherics/pipe/smart/manifold4w/supply/hidden/layer4,
/turf/open/floor/iron,
/area/station/command/heads_quarters/nt_rep)

(1,1,1) = {"
X
k
k
k
k
k
k
X
"}
(2,1,1) = {"
c
h
K
H
d
I
O
f
"}
(3,1,1) = {"
X
k
C
o
s
I
x
X
"}
(4,1,1) = {"
X
k
G
S
W
Y
e
X
"}
(5,1,1) = {"
X
k
V
a
l
k
T
X
"}
(6,1,1) = {"
X
k
B
z
k
k
X
X
"}
(7,1,1) = {"
X
k
I
k
k
X
X
X
"}
