//MAP CONVERTED BY dmm2tgm.py THIS HEADER COMMENT PREVENTS RECONVERSION, DO NOT REMOVE
"a" = (
/turf/closed/wall/r_wall,
/area/station/security/armory)
"b" = (
/obj/effect/turf_decal/stripes/end{
	dir = 8
	},
/obj/effect/turf_decal/tile/neutral/half/contrasted{
	dir = 4
	},
/turf/open/floor/iron/dark,
/area/station/security/armory)
"c" = (
/obj/effect/turf_decal/stripes/line{
	dir = 1
	},
/obj/effect/turf_decal/stripes/corner,
/obj/effect/turf_decal/tile/red/half/contrasted{
	dir = 4
	},
/turf/open/floor/iron/showroomfloor,
/area/station/security/armory)
"d" = (
/obj/effect/turf_decal/stripes/corner{
	dir = 1
	},
/obj/machinery/atmospherics/pipe/smart/manifold4w/scrubbers/hidden/layer2,
/obj/machinery/atmospherics/pipe/smart/manifold4w/supply/hidden/layer4,
/obj/effect/turf_decal/tile/neutral/half/contrasted,
/turf/open/floor/iron/showroomfloor,
/area/station/security/armory)
"e" = (
/obj/effect/turf_decal/stripes/corner{
	dir = 4
	},
/obj/machinery/atmospherics/pipe/smart/manifold4w/supply/hidden/layer4,
/obj/structure/cable,
/obj/effect/turf_decal/tile/neutral/half/contrasted,
/turf/open/floor/iron/showroomfloor,
/area/station/security/armory)
"f" = (
/obj/item/storage/box/chemimp{
	pixel_x = 6;
	pixel_y = 6
	},
/obj/item/storage/box/trackimp{
	pixel_x = -6;
	pixel_y = 6
	},
/obj/structure/table,
/obj/machinery/light/directional/south,
/obj/structure/reagent_dispensers/wall/peppertank/directional/south,
/obj/item/storage/box/firingpins,
/obj/item/storage/box/firingpins,
/obj/item/storage/lockbox/loyalty,
/obj/effect/turf_decal/tile/neutral/half/contrasted{
	dir = 1
	},
/turf/open/floor/iron/dark,
/area/station/security/armory)
"i" = (
/obj/item/clothing/mask/gas/sechailer{
	pixel_x = -3;
	pixel_y = 3
	},
/obj/item/clothing/mask/gas/sechailer,
/obj/item/clothing/mask/gas/sechailer{
	pixel_x = 3;
	pixel_y = -3
	},
/obj/item/flashlight/seclite,
/obj/item/flashlight/seclite,
/obj/item/flashlight/seclite,
/obj/effect/decal/cleanable/cobweb,
/obj/machinery/airalarm/directional/west,
/obj/structure/table,
/obj/effect/turf_decal/tile/neutral,
/turf/open/floor/iron/dark,
/area/station/security/armory)
"j" = (
/obj/structure/rack,
/obj/effect/turf_decal/bot,
/obj/structure/window/reinforced/spawner/directional/south,
/obj/structure/window/reinforced/spawner/directional/east,
/obj/effect/decal/cleanable/dirt,
/obj/effect/turf_decal/tile/neutral/anticorner/contrasted{
	dir = 8
	},
/obj/effect/spawner/armory_spawn/shotguns,
/turf/open/floor/iron/showroomfloor,
/area/station/security/armory)
"k" = (
/obj/machinery/flasher/portable,
/obj/effect/decal/cleanable/dirt,
/obj/machinery/light/directional/north,
/obj/machinery/firealarm/directional/north,
/obj/effect/turf_decal/box,
/obj/effect/turf_decal/tile/neutral/anticorner/contrasted{
	dir = 8
	},
/turf/open/floor/iron/dark,
/area/station/security/armory)
"l" = (
/obj/effect/turf_decal/stripes/line{
	dir = 8
	},
/obj/machinery/atmospherics/pipe/smart/manifold4w/scrubbers/hidden/layer2,
/obj/machinery/atmospherics/pipe/smart/manifold4w/supply/hidden/layer4,
/obj/effect/turf_decal/tile/red/half/contrasted{
	dir = 1
	},
/turf/open/floor/iron/showroomfloor,
/area/station/security/armory)
"m" = (
/obj/effect/turf_decal/stripes/corner{
	dir = 4
	},
/obj/structure/cable,
/obj/effect/turf_decal/tile/neutral/half/contrasted{
	dir = 8
	},
/turf/open/floor/iron/showroomfloor,
/area/station/security/armory)
"n" = (
/obj/effect/turf_decal/stripes/line{
	dir = 10
	},
/obj/machinery/atmospherics/components/unary/vent_scrubber/on/layer2{
	dir = 1
	},
/obj/effect/turf_decal/tile/neutral{
	dir = 4
	},
/turf/open/floor/iron/showroomfloor,
/area/station/security/armory)
"o" = (
/obj/effect/turf_decal/stripes/line{
	dir = 4
	},
/obj/effect/decal/cleanable/dirt,
/obj/effect/landmark/event_spawn,
/obj/structure/cable,
/obj/effect/turf_decal/tile/red/half/contrasted{
	dir = 1
	},
/turf/open/floor/iron/showroomfloor,
/area/station/security/armory)
"p" = (
/obj/structure/sign/nanotrasen,
/turf/closed/wall/r_wall/rust,
/area/station/security/armory)
"q" = (
/obj/structure/table/reinforced,
/obj/effect/turf_decal/delivery,
/obj/machinery/door/firedoor,
/obj/item/folder/red,
/obj/item/pen,
/obj/machinery/door/window/brigdoor/right/directional/west{
	name = "Armoury Desk";
	req_access = list("armory")
	},
/turf/open/floor/plating,
/area/station/security/armory)
"s" = (
/turf/closed/wall/r_wall/rust,
/area/station/security/armory)
"t" = (
/obj/effect/turf_decal/delivery,
/obj/machinery/atmospherics/pipe/smart/manifold4w/scrubbers/hidden/layer2,
/obj/machinery/atmospherics/pipe/smart/manifold4w/supply/hidden/layer4,
/obj/machinery/door/airlock/security{
	name = "Armoury"
	},
/obj/effect/mapping_helpers/airlock/access/all/security/armory,
/turf/open/floor/iron/dark,
/area/station/security/armory)
"u" = (
/obj/structure/rack,
/obj/effect/turf_decal/bot,
/obj/structure/window/reinforced/spawner/directional/south,
/obj/structure/window/reinforced/spawner/directional/west,
/obj/effect/turf_decal/tile/neutral/anticorner/contrasted,
/obj/effect/spawner/armory_spawn/mod_lasers_small,
/turf/open/floor/iron/showroomfloor,
/area/station/security/armory)
"v" = (
/obj/machinery/flasher/portable,
/obj/effect/turf_decal/box,
/obj/effect/turf_decal/tile/neutral{
	dir = 8
	},
/turf/open/floor/iron/dark,
/area/station/security/armory)
"w" = (
/obj/structure/rack,
/obj/effect/turf_decal/bot,
/obj/effect/decal/cleanable/dirt,
/obj/effect/turf_decal/tile/neutral/half/contrasted{
	dir = 4
	},
/obj/effect/spawner/random/armory/bulletproof_armor,
/obj/effect/spawner/random/armory/bulletproof_helmet,
/turf/open/floor/iron/dark,
/area/station/security/armory)
"x" = (
/obj/structure/cable,
/obj/structure/closet/secure_closet{
	name = "contraband locker";
	req_access = list("armory")
	},
/obj/effect/spawner/random/contraband/armory,
/obj/effect/spawner/random/maintenance/three,
/obj/machinery/power/apc/auto_name/directional/south,
/obj/effect/turf_decal/tile/neutral/half/contrasted{
	dir = 1
	},
/turf/open/floor/iron/dark,
/area/station/security/armory)
"z" = (
/obj/effect/turf_decal/stripes/line{
	dir = 6
	},
/obj/structure/cable,
/obj/effect/turf_decal/tile/neutral{
	dir = 1
	},
/turf/open/floor/iron/showroomfloor,
/area/station/security/armory)
"A" = (
/obj/structure/sign/warning/secure_area,
/turf/closed/wall/r_wall,
/area/station/security/armory)
"C" = (
/obj/effect/turf_decal/stripes/line{
	dir = 8
	},
/obj/machinery/atmospherics/pipe/smart/manifold4w/scrubbers/hidden/layer2,
/obj/effect/turf_decal/tile/neutral/half/contrasted{
	dir = 4
	},
/turf/open/floor/iron/showroomfloor,
/area/station/security/armory)
"D" = (
/obj/effect/turf_decal/delivery,
/obj/machinery/door/poddoor/shutters{
	dir = 4;
	id = "sidearmory";
	name = "Side Armoury Shutter"
	},
/obj/machinery/button/door/directional/south{
	id = "sidearmory";
	name = "Armoury Shutter Toggle";
	req_access = list("armory")
	},
/turf/open/floor/iron/dark,
/area/station/security/armory)
"F" = (
/obj/effect/turf_decal/stripes/line{
	dir = 9
	},
/obj/machinery/atmospherics/pipe/smart/manifold4w/scrubbers/hidden/layer2,
/obj/effect/turf_decal/tile/neutral,
/turf/open/floor/iron/showroomfloor,
/area/station/security/armory)
"G" = (
/obj/effect/turf_decal/stripes/line{
	dir = 6
	},
/obj/effect/turf_decal/tile/red/half/contrasted{
	dir = 4
	},
/turf/open/floor/iron/showroomfloor,
/area/station/security/armory)
"H" = (
/obj/effect/turf_decal/stripes/corner,
/obj/structure/cable,
/obj/effect/turf_decal/tile/neutral/half/contrasted{
	dir = 8
	},
/turf/open/floor/iron/showroomfloor,
/area/station/security/armory)
"I" = (
/obj/effect/turf_decal/stripes/line,
/obj/effect/turf_decal/tile/neutral/half/contrasted{
	dir = 1
	},
/turf/open/floor/iron/showroomfloor,
/area/station/security/armory)
"J" = (
/obj/structure/rack,
/obj/item/gun/energy/ionrifle{
	pixel_y = 4
	},
/obj/item/gun/energy/temperature/security,
/obj/effect/turf_decal/bot,
/obj/item/clothing/suit/hooded/ablative,
/obj/machinery/light_switch/directional/east,
/obj/effect/turf_decal/tile/neutral/half/contrasted{
	dir = 1
	},
/obj/item/gun/ballistic/automatic/battle_rifle,
/turf/open/floor/iron/dark,
/area/station/security/armory)
"K" = (
/obj/structure/rack,
/obj/effect/turf_decal/bot,
/obj/structure/window/reinforced/spawner/directional/north,
/obj/structure/window/reinforced/spawner/directional/east,
/obj/effect/turf_decal/tile/neutral/anticorner/contrasted{
	dir = 1
	},
/obj/effect/spawner/armory_spawn/smg,
/turf/open/floor/iron/showroomfloor,
/area/station/security/armory)
"L" = (
/obj/effect/turf_decal/delivery,
/obj/machinery/door/airlock/security{
	name = "Armoury"
	},
/obj/structure/cable,
/obj/effect/mapping_helpers/airlock/access/all/security/armory,
/turf/open/floor/iron/dark,
/area/station/security/armory)
"M" = (
/obj/effect/turf_decal/bot,
/obj/effect/decal/cleanable/dirt,
/obj/effect/turf_decal/tile/neutral/half/contrasted{
	dir = 1
	},
/obj/structure/rack,
/obj/effect/spawner/random/armory/dragnet,
/obj/effect/spawner/random/armory/dragnet,
/turf/open/floor/iron/dark,
/area/station/security/armory)
"N" = (
/obj/structure/table,
/obj/structure/extinguisher_cabinet/directional/east,
/obj/effect/turf_decal/tile/neutral{
	dir = 1
	},
/obj/item/clothing/glasses/hud/security/sunglasses/gars{
	pixel_x = 3;
	pixel_y = -2
	},
/obj/item/clothing/glasses/hud/security/sunglasses/gars{
	pixel_x = 3;
	pixel_y = 2
	},
/obj/item/clothing/glasses/hud/security/sunglasses{
	pixel_x = -3;
	pixel_y = 2
	},
/obj/item/clothing/glasses/hud/security/sunglasses{
	pixel_x = -3;
	pixel_y = -2
	},
/turf/open/floor/iron/dark,
/area/station/security/armory)
"O" = (
/obj/structure/rack,
/obj/effect/turf_decal/bot,
/obj/effect/turf_decal/tile/neutral/half/contrasted{
	dir = 4
	},
/obj/effect/spawner/random/armory/riot_armor,
/obj/effect/spawner/random/armory/riot_helmet,
/obj/effect/spawner/random/armory/riot_shield,
/turf/open/floor/iron/dark,
/area/station/security/armory)
"P" = (
/obj/effect/turf_decal/stripes/line,
/obj/effect/turf_decal/tile/neutral/half/contrasted{
	dir = 1
	},
/mob/living/basic/bot/secbot/beepsky/armsky,
/turf/open/floor/iron/showroomfloor,
/area/station/security/armory)
"Q" = (
/obj/item/storage/box/rubbershot{
	pixel_x = -3;
	pixel_y = 3
	},
/obj/item/storage/box/rubbershot{
	pixel_x = -3;
	pixel_y = 3
	},
/obj/item/storage/box/rubbershot,
/obj/item/storage/box/rubbershot,
/obj/item/storage/box/rubbershot{
	pixel_x = 3;
	pixel_y = -3
	},
/obj/item/storage/box/rubbershot{
	pixel_x = 3;
	pixel_y = -3
	},
/obj/structure/closet/secure_closet{
	name = "shotgun rubber rounds locker";
	req_access = list("armory")
	},
/obj/effect/turf_decal/bot,
/obj/effect/decal/cleanable/dirt,
/obj/effect/turf_decal/tile/neutral{
	dir = 4
	},
/turf/open/floor/iron/dark,
/area/station/security/armory)
"R" = (
/obj/effect/turf_decal/tile/neutral{
	dir = 4
	},
/obj/structure/table,
/obj/effect/spawner/random/armory/barrier_grenades,
/obj/item/key/security,
/obj/item/key/security,
/turf/open/floor/iron/dark,
/area/station/security/armory)
"T" = (
/obj/structure/rack,
/obj/effect/turf_decal/bot,
/obj/structure/window/reinforced/spawner/directional/north,
/obj/structure/window/reinforced/spawner/directional/west,
/obj/effect/turf_decal/tile/neutral/anticorner/contrasted{
	dir = 4
	},
/obj/effect/spawner/armory_spawn/mod_lasers_big,
/turf/open/floor/iron/showroomfloor,
/area/station/security/armory)
"U" = (
/obj/effect/turf_decal/stripes/corner{
	dir = 1
	},
/obj/effect/turf_decal/stripes/corner{
	dir = 8
	},
/obj/machinery/atmospherics/pipe/smart/manifold4w/scrubbers/hidden/layer2,
/obj/effect/turf_decal/tile/neutral/half/contrasted{
	dir = 4
	},
/turf/open/floor/iron/showroomfloor,
/area/station/security/armory)
"V" = (
/obj/effect/turf_decal/bot,
/obj/effect/turf_decal/tile/neutral/half/contrasted,
/obj/machinery/dish_drive/bullet{
	suck_distance = 0
	},
/turf/open/floor/iron/dark,
/area/station/security/armory)
"W" = (
/obj/effect/turf_decal/bot,
/obj/effect/decal/cleanable/dirt,
/obj/item/radio/intercom/directional/south,
/obj/effect/turf_decal/tile/neutral/half/contrasted{
	dir = 1
	},
/obj/structure/rack,
/obj/item/storage/box/teargas{
	pixel_x = 1;
	pixel_y = -2
	},
/obj/item/storage/box/flashes{
	pixel_x = 3
	},
/obj/item/gun/grenadelauncher,
/turf/open/floor/iron/dark,
/area/station/security/armory)
"X" = (
/obj/machinery/door/firedoor,
/obj/machinery/door/airlock/command{
	name = "Armoury"
	},
/obj/effect/mapping_helpers/airlock/access/all/security/hos,
/obj/machinery/door/poddoor/shutters{
	dir = 8;
	id = "frontarmory";
	name = "Front Armoury Shutter"
	},
/obj/machinery/button/door/directional/north{
	id = "frontarmory";
	name = "Armoury Shutter Toggle";
	req_access = list("armory")
	},
/turf/open/floor/iron/dark,
/area/station/security/armory)
"Y" = (
/obj/effect/turf_decal/stripes/line{
	dir = 5
	},
/obj/effect/decal/cleanable/dirt,
/obj/machinery/atmospherics/components/unary/vent_pump/on/layer4{
	dir = 8
	},
/obj/structure/cable,
/obj/effect/turf_decal/tile/neutral{
	dir = 8
	},
/turf/open/floor/iron/showroomfloor,
/area/station/security/armory)
"Z" = (
/obj/machinery/flasher/portable,
/obj/machinery/camera/motion/directional/east{
	c_tag = "Armoury Internal"
	},
/obj/effect/turf_decal/box,
/obj/effect/turf_decal/tile/neutral/anticorner/contrasted{
	dir = 8
	},
/turf/open/floor/iron/dark,
/area/station/security/armory)

(1,1,1) = {"
a
a
a
s
X
a
s
a
"}
(2,1,1) = {"
a
i
w
O
b
Q
R
p
"}
(3,1,1) = {"
a
V
F
C
U
n
f
s
"}
(4,1,1) = {"
t
l
d
K
j
I
M
a
"}
(5,1,1) = {"
L
o
e
T
u
P
W
a
"}
(6,1,1) = {"
a
k
Y
m
H
z
x
s
"}
(7,1,1) = {"
A
v
Z
c
G
J
N
a
"}
(8,1,1) = {"
a
a
A
q
D
a
a
a
"}
