//MAP CONVERTED BY dmm2tgm.py THIS HEADER COMMENT PREVENTS RECONVERSION, DO NOT REMOVE
"a" = (
/turf/template_noop,
/area/template_noop)
"k" = (
/obj/machinery/newscaster/directional/east,
/obj/effect/turf_decal/tile/neutral/half/contrasted{
	dir = 8
	},
/obj/structure/closet/secure_closet/security/service,
/turf/open/floor/iron/dark,
/area/station/service/bar/backroom)

(1,1,1) = {"
a
a
a
a
"}
(2,1,1) = {"
a
a
a
a
"}
(3,1,1) = {"
a
k
a
a
"}
