//MAP CONVERTED BY dmm2tgm.py THIS HEADER COMMENT PREVENTS RECONVERSION, DO NOT REMOVE
"a" = (
/turf/template_noop,
/area/deathmatch)
"b" = (
/turf/closed/wall/r_wall/syndicate/nodiagonal,
/area/deathmatch)
"c" = (
/obj/effect/turf_decal/nova_decals/syndicate/top/right,
/turf/open/floor/mineral/plastitanium/red,
/area/deathmatch)
"d" = (
/obj/structure/table/reinforced/ctf,
/obj/item/storage/medkit{
	pixel_y = 4;
	pixel_x = 1
	},
/obj/structure/fluff/fake_camera,
/turf/open/floor/mineral/plastitanium,
/area/deathmatch)
"e" = (
/obj/structure/table/reinforced/plastitaniumglass,
/obj/structure/table/reinforced/ctf,
/obj/structure/table/reinforced/plastitaniumglass,
/turf/open/floor/plating/airless,
/area/deathmatch)
"f" = (
/turf/open/floor/mineral/plastitanium,
/area/deathmatch)
"g" = (
/obj/structure/rack/shelf,
/obj/item/forging/reagent_weapon/axe{
	pixel_y = -3
	},
/obj/item/forging/reagent_weapon/axe{
	pixel_x = -3;
	pixel_y = 3
	},
/turf/open/floor/mineral/plastitanium,
/area/deathmatch)
"h" = (
/obj/effect/spawner/structure/window/reinforced/plasma/plastitanium,
/turf/open/floor/plating/airless,
/area/deathmatch)
"i" = (
/obj/effect/turf_decal/nova_decals/syndicate/middle/middle,
/obj/effect/light_emitter{
	set_cap = 2;
	light_color = "#DEEFFF";
	set_luminosity = 4
	},
/turf/open/floor/mineral/plastitanium/red,
/area/deathmatch)
"k" = (
/obj/machinery/light/floor,
/obj/effect/turf_decal/bot_red,
/turf/open/floor/plating/airless,
/area/deathmatch)
"l" = (
/obj/effect/turf_decal/stripes/red/corner{
	dir = 8
	},
/turf/open/floor/mineral/plastitanium,
/area/deathmatch)
"m" = (
/obj/effect/turf_decal/nova_decals/syndicate/middle/right,
/turf/open/floor/mineral/plastitanium/red,
/area/deathmatch)
"n" = (
/obj/effect/turf_decal/stripes/red/line{
	dir = 1
	},
/turf/open/floor/mineral/plastitanium,
/area/deathmatch)
"o" = (
/obj/structure/lattice,
/turf/template_noop,
/area/deathmatch)
"q" = (
/obj/structure/table/reinforced/plastitaniumglass,
/obj/structure/table/reinforced/ctf,
/obj/structure/table/reinforced/ctf,
/obj/structure/table/reinforced/plastitaniumglass,
/obj/structure/table/reinforced/plastitaniumglass,
/turf/open/floor/plating/airless,
/area/deathmatch)
"r" = (
/obj/effect/turf_decal/nova_decals/syndicate/top/middle,
/turf/open/floor/mineral/plastitanium/red,
/area/deathmatch)
"s" = (
/obj/effect/turf_decal/stripes/red/line,
/turf/open/floor/mineral/plastitanium,
/area/deathmatch)
"t" = (
/turf/closed/indestructible/syndicate,
/area/deathmatch)
"v" = (
/obj/effect/landmark/deathmatch_player_spawn,
/turf/open/floor/mineral/plastitanium,
/area/deathmatch)
"w" = (
/obj/structure/rack/shelf,
/obj/item/forging/reagent_weapon/dagger{
	pixel_x = -3;
	pixel_y = 3
	},
/obj/item/forging/reagent_weapon/dagger{
	pixel_y = -3
	},
/turf/open/floor/mineral/plastitanium,
/area/deathmatch)
"y" = (
/obj/effect/turf_decal/nova_decals/syndicate/bottom/left,
/turf/open/floor/mineral/plastitanium/red,
/area/deathmatch)
"z" = (
/obj/effect/turf_decal/nova_decals/syndicate/middle/left,
/turf/open/floor/mineral/plastitanium/red,
/area/deathmatch)
"A" = (
/obj/machinery/light/directional/east,
/turf/open/floor/mineral/plastitanium,
/area/deathmatch)
"B" = (
/turf/closed/wall/r_wall/syndicate,
/area/deathmatch)
"D" = (
/obj/structure/rack,
/obj/item/forging/reagent_weapon/katana{
	pixel_x = -6
	},
/obj/item/forging/reagent_weapon/sword{
	pixel_x = 6
	},
/turf/open/floor/mineral/plastitanium,
/area/deathmatch)
"E" = (
/obj/structure/rack,
/obj/item/forging/reagent_weapon/spear{
	pixel_x = 3
	},
/obj/item/forging/reagent_weapon/hammer{
	pixel_x = -3
	},
/turf/open/floor/mineral/plastitanium,
/area/deathmatch)
"F" = (
/obj/structure/table/reinforced/ctf,
/obj/item/storage/medkit{
	pixel_y = 4;
	pixel_x = 1
	},
/obj/structure/fluff/fake_camera{
	dir = 9
	},
/turf/open/floor/mineral/plastitanium,
/area/deathmatch)
"H" = (
/obj/machinery/light/directional/west,
/turf/open/floor/mineral/plastitanium,
/area/deathmatch)
"I" = (
/obj/effect/turf_decal/nova_decals/syndicate/bottom/right,
/turf/open/floor/mineral/plastitanium/red,
/area/deathmatch)
"J" = (
/obj/effect/turf_decal/stripes/red/corner{
	dir = 4
	},
/turf/open/floor/mineral/plastitanium,
/area/deathmatch)
"K" = (
/obj/structure/marker_beacon/burgundy,
/turf/open/floor/mineral/plastitanium,
/area/deathmatch)
"L" = (
/obj/structure/table/reinforced/ctf,
/obj/item/storage/medkit{
	pixel_y = 4;
	pixel_x = 1
	},
/obj/structure/fluff/fake_camera{
	dir = 10
	},
/turf/open/floor/mineral/plastitanium,
/area/deathmatch)
"M" = (
/obj/machinery/light/directional/south,
/turf/open/floor/mineral/plastitanium,
/area/deathmatch)
"O" = (
/obj/effect/turf_decal/stripes/red/corner{
	dir = 1
	},
/turf/open/floor/mineral/plastitanium,
/area/deathmatch)
"P" = (
/obj/effect/turf_decal/stripes/red/line{
	dir = 8
	},
/turf/open/floor/mineral/plastitanium,
/area/deathmatch)
"Q" = (
/obj/effect/turf_decal/stripes/red/line{
	dir = 4
	},
/turf/open/floor/mineral/plastitanium,
/area/deathmatch)
"R" = (
/obj/effect/turf_decal/nova_decals/syndicate/bottom/middle,
/turf/open/floor/mineral/plastitanium/red,
/area/deathmatch)
"S" = (
/obj/machinery/light/directional/north,
/turf/open/floor/mineral/plastitanium,
/area/deathmatch)
"T" = (
/obj/structure/table/reinforced/ctf,
/obj/item/storage/medkit{
	pixel_y = 4;
	pixel_x = 1
	},
/obj/structure/fluff/fake_camera{
	dir = 4
	},
/turf/open/floor/mineral/plastitanium,
/area/deathmatch)
"U" = (
/obj/structure/emergency_shield/timer,
/turf/open/floor/mineral/plastitanium,
/area/deathmatch)
"V" = (
/obj/effect/turf_decal/nova_decals/syndicate/top/left,
/turf/open/floor/mineral/plastitanium/red,
/area/deathmatch)
"W" = (
/obj/structure/emergency_shield/timer,
/obj/effect/light_emitter{
	set_cap = 2;
	light_color = "#DEEFFF";
	set_luminosity = 4
	},
/turf/open/floor/mineral/plastitanium,
/area/deathmatch)
"X" = (
/obj/effect/turf_decal/stripes/red/corner,
/turf/open/floor/mineral/plastitanium,
/area/deathmatch)
"Y" = (
/obj/structure/lattice,
/obj/structure/marker_beacon/burgundy,
/turf/template_noop,
/area/deathmatch)
"Z" = (
/turf/open/ai_visible,
/area/deathmatch)

(1,1,1) = {"
Z
Z
Z
Z
Z
Z
b
B
B
B
B
B
b
Z
Z
Z
Z
Z
Z
"}
(2,1,1) = {"
Z
Y
o
o
o
o
B
w
g
L
E
D
t
o
o
o
o
Y
Z
"}
(3,1,1) = {"
Z
o
a
a
a
a
B
S
f
v
f
M
t
a
a
a
a
o
Z
"}
(4,1,1) = {"
Z
o
a
h
h
h
B
U
U
W
U
U
B
h
h
h
a
o
Z
"}
(5,1,1) = {"
Z
o
a
h
e
e
k
f
f
f
f
f
k
e
e
h
a
o
Z
"}
(6,1,1) = {"
Z
o
a
h
e
q
e
f
f
f
f
f
e
q
e
h
a
o
Z
"}
(7,1,1) = {"
b
B
B
B
k
e
e
f
f
K
f
f
e
e
k
B
t
t
b
"}
(8,1,1) = {"
B
D
H
U
f
f
f
X
Q
Q
Q
J
f
f
f
U
H
w
B
"}
(9,1,1) = {"
B
E
f
U
f
f
f
s
V
z
y
n
f
f
f
U
f
g
B
"}
(10,1,1) = {"
B
F
v
W
f
f
K
s
r
i
R
n
K
f
f
W
v
d
B
"}
(11,1,1) = {"
B
g
f
U
f
f
f
s
c
m
I
n
f
f
f
U
f
E
B
"}
(12,1,1) = {"
B
w
A
U
f
f
f
l
P
P
P
O
f
f
f
U
A
D
B
"}
(13,1,1) = {"
b
B
B
B
k
e
e
f
f
K
f
f
e
e
k
B
B
B
b
"}
(14,1,1) = {"
Z
o
a
h
e
q
e
f
f
f
f
f
e
q
e
h
a
o
Z
"}
(15,1,1) = {"
Z
o
a
h
e
e
k
f
f
f
f
f
k
e
e
h
a
o
Z
"}
(16,1,1) = {"
Z
o
a
h
h
h
B
U
U
W
U
U
B
h
h
h
a
o
Z
"}
(17,1,1) = {"
Z
o
a
a
a
a
B
S
f
v
f
M
B
a
a
a
a
o
Z
"}
(18,1,1) = {"
Z
Y
o
o
o
o
B
E
D
T
g
w
B
o
o
o
o
Y
Z
"}
(19,1,1) = {"
Z
Z
Z
Z
Z
Z
b
B
B
B
B
B
b
Z
Z
Z
Z
Z
Z
"}
