//MAP CONVERTED BY dmm2tgm.py THIS HEADER COMMENT PREVENTS RECONVERSION, DO NOT REMOVE
"a" = (
/turf/open/space/basic,
/area/deathmatch)
"c" = (
/turf/open/floor/iron,
/area/deathmatch)
"g" = (
/turf/cordon,
/area/template_noop)
"h" = (
/obj/structure/sign/nanotrasen{
	pixel_y = 32
	},
/turf/open/space/basic,
/area/deathmatch)
"i" = (
/obj/structure/rack,
/obj/item/gun/energy/laser/retro,
/obj/machinery/light/directional/south,
/turf/open/floor/iron,
/area/deathmatch)
"j" = (
/obj/structure/lattice,
/turf/open/space/basic,
/area/deathmatch)
"k" = (
/turf/open/floor/plating,
/area/deathmatch)
"l" = (
/obj/machinery/light/floor/broken,
/turf/open/floor/plating,
/area/deathmatch)
"n" = (
/turf/open/floor/iron/half{
	dir = 8
	},
/area/deathmatch)
"s" = (
/obj/machinery/nuclearbomb,
/turf/open/floor/iron/recharge_floor,
/area/deathmatch)
"t" = (
/obj/structure/lattice,
/obj/machinery/light/broken/directional/north,
/turf/open/space/basic,
/area/deathmatch)
"u" = (
/turf/open/floor/iron/corner{
	dir = 8
	},
/area/deathmatch)
"w" = (
/obj/structure/rack,
/obj/item/gun/energy/laser/retro,
/obj/machinery/light/directional/north,
/turf/open/floor/iron,
/area/deathmatch)
"y" = (
/turf/closed/wall/mineral/titanium,
/area/deathmatch)
"z" = (
/obj/structure/fans/tiny/shield,
/turf/open/floor/vault,
/area/deathmatch)
"B" = (
/turf/open/floor/iron/half,
/area/deathmatch)
"D" = (
/turf/open/floor/vault,
/area/deathmatch)
"E" = (
/turf/open/floor/iron/corner,
/area/deathmatch)
"G" = (
/obj/structure/sign/nanotrasen{
	pixel_y = -32
	},
/turf/open/space/basic,
/area/deathmatch)
"H" = (
/turf/open/floor/iron/corner{
	dir = 1
	},
/area/deathmatch)
"I" = (
/obj/machinery/camera{
	dir = 9
	},
/turf/open/space/basic,
/area/deathmatch)
"J" = (
/obj/structure/table_frame,
/turf/open/floor/plating,
/area/deathmatch)
"K" = (
/obj/structure/girder,
/turf/open/floor/plating,
/area/deathmatch)
"O" = (
/obj/machinery/light/broken/directional/north,
/turf/open/floor/iron,
/area/deathmatch)
"S" = (
/obj/structure/table/reinforced,
/obj/machinery/recharger,
/obj/machinery/light/directional/south,
/turf/open/floor/iron,
/area/deathmatch)
"T" = (
/obj/machinery/light/broken/directional/south,
/turf/open/floor/iron,
/area/deathmatch)
"U" = (
/obj/structure/table/reinforced,
/obj/machinery/recharger,
/obj/machinery/light/directional/north,
/turf/open/floor/iron,
/area/deathmatch)
"V" = (
/turf/open/floor/iron/corner{
	dir = 4
	},
/area/deathmatch)
"W" = (
/obj/structure/fans/tiny,
/obj/machinery/door/airlock/titanium/glass,
/turf/open/floor/iron/small,
/area/deathmatch)
"X" = (
/obj/machinery/camera,
/turf/open/space/basic,
/area/deathmatch)
"Z" = (
/obj/structure/lattice,
/obj/structure/marker_beacon/cerulean,
/turf/open/space/basic,
/area/deathmatch)

(1,1,1) = {"
g
g
g
g
g
g
g
g
g
g
g
g
g
g
g
g
g
g
g
g
g
g
g
g
g
g
g
g
g
g
g
g
g
g
g
g
g
g
g
g
"}
(2,1,1) = {"
g
a
a
a
a
a
a
a
a
a
a
a
a
a
a
a
a
a
a
a
a
a
a
a
a
a
a
a
a
a
a
a
a
a
a
a
a
a
a
g
"}
(3,1,1) = {"
g
a
a
a
a
a
a
a
a
a
a
a
a
a
a
a
a
a
a
a
a
a
a
a
a
a
a
a
a
a
a
a
a
a
a
a
a
a
a
g
"}
(4,1,1) = {"
g
a
a
a
a
a
a
a
a
a
a
a
a
a
a
a
a
a
a
a
a
a
a
a
a
a
a
a
a
a
a
a
a
a
a
a
a
a
a
g
"}
(5,1,1) = {"
g
a
a
a
a
a
a
a
a
a
a
a
a
a
a
a
a
a
a
a
a
a
a
a
a
a
a
a
a
a
a
a
a
a
a
a
a
a
a
g
"}
(6,1,1) = {"
g
a
a
a
a
a
a
a
a
a
a
a
a
a
a
a
a
a
a
a
a
a
a
a
a
a
a
a
a
a
a
a
a
a
a
a
a
a
a
g
"}
(7,1,1) = {"
g
a
a
a
a
a
a
a
a
a
a
a
a
a
a
a
a
a
a
a
a
a
a
a
a
a
a
a
a
a
a
a
a
a
a
a
a
a
a
g
"}
(8,1,1) = {"
g
a
a
a
a
a
a
a
a
a
a
a
a
a
a
a
a
a
a
a
a
a
a
a
a
a
a
a
a
a
a
a
a
a
a
a
a
a
a
g
"}
(9,1,1) = {"
g
a
a
a
a
a
a
a
a
a
a
a
a
a
a
a
a
a
a
a
a
a
a
a
a
a
a
a
a
a
a
a
a
a
a
a
a
a
a
g
"}
(10,1,1) = {"
g
a
a
a
a
a
a
a
a
a
a
a
a
a
a
a
a
K
k
a
a
a
a
a
a
a
a
a
a
a
a
a
a
a
a
a
a
a
a
g
"}
(11,1,1) = {"
g
a
a
a
a
a
a
a
a
a
a
a
a
a
a
a
a
j
j
a
a
a
a
a
a
a
a
a
a
a
a
a
a
a
a
a
a
a
a
g
"}
(12,1,1) = {"
g
a
a
a
a
a
a
a
a
a
a
a
a
a
a
a
a
j
a
a
a
a
a
a
a
a
a
a
a
a
a
a
a
a
a
a
a
a
a
g
"}
(13,1,1) = {"
g
a
a
a
a
a
a
a
a
a
a
a
a
a
a
a
a
a
a
a
a
j
a
a
a
a
a
a
a
a
a
a
a
a
a
a
a
a
a
g
"}
(14,1,1) = {"
g
a
a
a
a
a
a
a
a
a
a
a
a
a
a
a
a
a
a
j
k
k
a
a
a
a
a
a
a
a
a
a
a
a
a
a
a
a
a
g
"}
(15,1,1) = {"
g
a
a
a
a
a
a
a
a
a
a
a
a
a
a
a
a
a
a
k
T
y
a
a
a
a
a
a
a
a
a
a
a
a
a
a
a
a
a
g
"}
(16,1,1) = {"
g
a
a
a
a
a
a
a
a
a
a
a
a
a
a
a
a
a
K
W
y
K
a
a
a
a
a
a
a
a
a
a
a
a
a
a
a
a
a
g
"}
(17,1,1) = {"
g
a
a
a
a
a
a
a
a
a
a
a
a
a
a
a
a
a
Z
k
Z
a
a
a
a
a
a
a
a
a
a
a
a
a
a
a
a
a
a
g
"}
(18,1,1) = {"
g
a
a
a
a
a
a
a
a
a
a
a
a
a
a
a
a
y
y
W
y
y
h
a
a
a
a
a
a
a
a
a
a
a
a
a
a
a
a
g
"}
(19,1,1) = {"
g
a
a
a
a
a
a
a
a
a
a
a
a
a
a
a
X
y
U
c
i
y
a
a
a
a
a
a
a
a
a
a
a
a
a
a
a
a
a
g
"}
(20,1,1) = {"
g
a
a
a
a
a
a
a
a
a
a
a
a
a
a
a
a
z
E
n
V
z
a
a
a
a
a
a
a
a
a
a
a
a
a
a
a
a
a
g
"}
(21,1,1) = {"
g
a
a
a
a
a
a
a
a
a
a
a
a
a
a
a
a
z
B
s
B
z
a
a
a
a
a
a
a
a
a
a
a
a
a
a
a
a
a
g
"}
(22,1,1) = {"
g
a
a
a
a
a
a
a
a
a
a
a
a
a
a
a
a
z
u
n
H
z
a
a
a
a
a
a
a
a
a
a
a
a
a
a
a
a
a
g
"}
(23,1,1) = {"
g
a
a
a
a
a
a
a
a
a
a
a
a
a
a
a
a
y
w
c
S
y
I
a
a
a
a
a
a
a
a
a
a
a
a
a
a
a
a
g
"}
(24,1,1) = {"
g
a
a
a
a
a
a
a
a
a
a
a
a
a
a
a
G
y
y
W
y
y
a
a
a
a
a
a
a
a
a
a
a
a
a
a
a
a
a
g
"}
(25,1,1) = {"
g
a
a
a
a
a
a
a
a
a
a
a
a
a
a
a
a
a
Z
k
Z
a
a
a
a
a
a
a
a
a
a
a
a
a
a
a
a
a
a
g
"}
(26,1,1) = {"
g
a
a
a
a
a
a
a
a
a
a
a
a
a
a
a
a
y
y
W
y
K
a
a
a
a
a
a
a
a
a
a
a
a
a
a
a
a
a
g
"}
(27,1,1) = {"
g
a
a
a
a
a
a
a
a
a
a
a
a
a
a
a
X
y
O
k
c
K
a
a
a
a
a
a
a
a
a
a
a
a
a
a
a
a
a
g
"}
(28,1,1) = {"
g
a
a
a
a
a
a
a
a
a
a
a
a
a
a
a
a
D
J
k
k
D
a
a
a
a
a
a
a
a
a
a
a
a
a
a
a
a
a
g
"}
(29,1,1) = {"
g
a
a
a
a
a
a
a
a
a
a
a
a
a
a
a
a
k
k
l
j
k
a
a
a
a
a
a
a
a
a
a
a
a
a
a
a
a
a
g
"}
(30,1,1) = {"
g
a
a
a
a
a
a
a
a
a
a
a
a
a
a
a
a
k
j
k
a
a
a
a
a
a
a
a
a
a
a
a
a
a
a
a
a
a
a
g
"}
(31,1,1) = {"
g
a
a
a
a
a
a
a
a
a
a
a
a
a
a
a
a
K
t
a
a
a
a
a
a
a
a
a
a
a
a
a
a
a
a
a
a
a
a
g
"}
(32,1,1) = {"
g
a
a
a
a
a
a
a
a
a
a
a
a
a
a
a
a
j
K
a
a
a
a
a
a
a
a
a
a
a
a
a
a
a
a
a
a
a
a
g
"}
(33,1,1) = {"
g
a
a
a
a
a
a
a
a
a
a
a
a
a
a
a
a
a
a
a
a
a
a
a
a
a
a
a
a
a
a
a
a
a
a
a
a
a
a
g
"}
(34,1,1) = {"
g
a
a
a
a
a
a
a
a
a
a
a
a
a
a
a
a
a
a
a
a
a
a
a
a
a
a
a
a
a
a
a
a
a
a
a
a
a
a
g
"}
(35,1,1) = {"
g
a
a
a
a
a
a
a
a
a
a
a
a
a
a
a
a
a
a
a
a
a
a
a
a
a
a
a
a
a
a
a
a
a
a
a
a
a
a
g
"}
(36,1,1) = {"
g
a
a
a
a
a
a
a
a
a
a
a
a
a
a
a
a
a
a
a
a
a
a
a
a
a
a
a
a
a
a
a
a
a
a
a
a
a
a
g
"}
(37,1,1) = {"
g
a
a
a
a
a
a
a
a
a
a
a
a
a
a
a
a
a
a
a
a
a
a
a
a
a
a
a
a
a
a
a
a
a
a
a
a
a
a
g
"}
(38,1,1) = {"
g
a
a
a
a
a
a
a
a
a
a
a
a
a
a
a
a
a
a
a
a
a
a
a
a
a
a
a
a
a
a
a
a
a
a
a
a
a
a
g
"}
(39,1,1) = {"
g
a
a
a
a
a
a
a
a
a
a
a
a
a
a
a
a
a
a
a
a
a
a
a
a
a
a
a
a
a
a
a
a
a
a
a
a
a
a
g
"}
(40,1,1) = {"
g
g
g
g
g
g
g
g
g
g
g
g
g
g
g
g
g
g
g
g
g
g
g
g
g
g
g
g
g
g
g
g
g
g
g
g
g
g
g
g
"}
