//MAP CONVERTED BY dmm2tgm.py THIS HEADER COMMENT PREVENTS RECONVERSION, DO NOT REMOVE
"ah" = (
/obj/machinery/door/airlock/survival_pod/glass,
/obj/effect/mapping_helpers/airlock/cyclelink_helper{
	dir = 4
	},
/turf/open/floor/grass,
/area/deathmatch)
"aG" = (
/obj/machinery/camera{
	dir = 9
	},
/turf/open/space/basic,
/area/deathmatch)
"bN" = (
/turf/open/floor/iron/corner{
	dir = 1
	},
/area/deathmatch)
"bW" = (
/obj/structure/flora/tree/palm,
/turf/open/floor/grass,
/area/deathmatch)
"cT" = (
/obj/machinery/power/shuttle_engine/heater{
	dir = 4
	},
/obj/effect/turf_decal/stripes/line{
	dir = 4
	},
/turf/open/floor/plating/airless,
/area/deathmatch)
"dx" = (
/obj/machinery/door/airlock/survival_pod/glass{
	dir = 4
	},
/obj/effect/mapping_helpers/airlock/cyclelink_helper,
/turf/open/floor/grass,
/area/deathmatch)
"dH" = (
/turf/closed/wall,
/area/deathmatch)
"eb" = (
/obj/machinery/computer{
	dir = 4
	},
/turf/open/floor/mineral/plastitanium,
/area/deathmatch)
"el" = (
/obj/item/gun/energy/recharge/kinetic_accelerator,
/obj/item/borg/upgrade/modkit/damage,
/obj/item/borg/upgrade/modkit/damage,
/obj/item/borg/upgrade/modkit/range,
/obj/item/borg/upgrade/modkit/range,
/turf/open/misc/asteroid/airless,
/area/deathmatch)
"ep" = (
/obj/structure/sign/warning/directional/east,
/turf/open/misc/asteroid/dug,
/area/deathmatch)
"fs" = (
/obj/machinery/light/broken/directional/south,
/turf/open/floor/iron,
/area/deathmatch)
"fG" = (
/obj/structure/lattice,
/obj/effect/landmark/deathmatch_player_spawn,
/turf/open/space/basic,
/area/deathmatch)
"hH" = (
/obj/machinery/porta_turret/syndicate{
	on = 0;
	dir = 1
	},
/turf/closed/wall/r_wall/syndicate,
/area/deathmatch)
"ip" = (
/turf/open/floor/plating,
/area/deathmatch)
"ir" = (
/turf/closed/mineral/asteroid,
/area/template_noop)
"is" = (
/obj/machinery/light/broken/directional/north,
/turf/open/floor/iron,
/area/deathmatch)
"kK" = (
/obj/structure/table_frame,
/turf/open/floor/plating,
/area/deathmatch)
"kO" = (
/obj/effect/mob_spawn/corpse/human/miner/explorer,
/turf/open/misc/asteroid/dug,
/area/deathmatch)
"lf" = (
/obj/structure/table/reinforced,
/obj/machinery/recharger,
/obj/machinery/light/directional/north,
/turf/open/floor/iron,
/area/deathmatch)
"ll" = (
/turf/open/floor/iron/corner{
	dir = 8
	},
/area/deathmatch)
"mq" = (
/turf/open/floor/iron/half,
/area/deathmatch)
"mL" = (
/turf/open/space/basic,
/area/template_noop)
"ne" = (
/mob/living/basic/carp/mega,
/turf/open/space/basic,
/area/deathmatch)
"og" = (
/obj/machinery/porta_turret/syndicate{
	on = 0
	},
/turf/closed/wall/r_wall/syndicate,
/area/deathmatch)
"oi" = (
/obj/structure/flora/bush/flowers_br/style_random,
/turf/open/floor/grass,
/area/deathmatch)
"qg" = (
/turf/closed/wall/mineral/titanium,
/area/deathmatch)
"qw" = (
/turf/closed/mineral/random,
/area/deathmatch)
"rg" = (
/turf/open/floor/iron/corner,
/area/deathmatch)
"ry" = (
/obj/structure/sign/warning/directional/north,
/obj/structure/flora/rock/pile/icy/style_random,
/turf/open/misc/asteroid/airless,
/area/deathmatch)
"rN" = (
/turf/closed/mineral/asteroid,
/area/deathmatch)
"sy" = (
/obj/structure/lattice/catwalk,
/obj/item/toy/crayon/spraycan{
	pixel_x = -5;
	pixel_y = 4
	},
/turf/open/space/basic,
/area/deathmatch)
"tc" = (
/obj/structure/fans/tiny/shield,
/turf/open/floor/vault,
/area/deathmatch)
"vn" = (
/obj/effect/spawner/random/structure/billboard,
/turf/open/misc/asteroid/airless,
/area/deathmatch)
"vy" = (
/obj/effect/landmark/deathmatch_player_spawn,
/turf/open/floor/plating,
/area/deathmatch)
"vB" = (
/obj/structure/fans/tiny,
/obj/machinery/door/airlock/titanium/glass,
/turf/open/floor/iron/small,
/area/deathmatch)
"wf" = (
/turf/open/space/basic,
/area/deathmatch)
"wi" = (
/obj/effect/landmark/deathmatch_player_spawn,
/turf/open/misc/asteroid/airless,
/area/deathmatch)
"xM" = (
/obj/structure/marker_beacon{
	light_color = "#FFE8AA";
	light_range = 20
	},
/turf/open/floor/grass,
/area/deathmatch)
"yg" = (
/turf/closed/wall/r_wall/syndicate,
/area/deathmatch)
"ys" = (
/obj/structure/lattice/catwalk,
/turf/open/space/basic,
/area/deathmatch)
"yB" = (
/obj/structure/lattice,
/obj/structure/marker_beacon/cerulean,
/turf/open/space/basic,
/area/deathmatch)
"zj" = (
/obj/structure/flora/bush/fullgrass/style_random,
/turf/open/floor/grass,
/area/deathmatch)
"Ar" = (
/obj/structure/rack,
/obj/item/gun/energy/laser/retro,
/obj/machinery/light/directional/north,
/turf/open/floor/iron,
/area/deathmatch)
"Bh" = (
/turf/open/floor/vault,
/area/deathmatch)
"CT" = (
/obj/structure/rack,
/obj/item/gun/energy/laser/retro,
/obj/machinery/light/directional/south,
/turf/open/floor/iron,
/area/deathmatch)
"CV" = (
/obj/machinery/nuclearbomb,
/obj/effect/light_emitter{
	set_cap = 2;
	light_color = "#DEEFFF";
	set_luminosity = 4
	},
/turf/open/floor/iron/recharge_floor,
/area/deathmatch)
"CW" = (
/obj/structure/sign/nanotrasen{
	pixel_y = 32
	},
/turf/open/space/basic,
/area/deathmatch)
"Eb" = (
/turf/closed/mineral/random,
/area/template_noop)
"El" = (
/obj/structure/girder,
/turf/open/floor/plating,
/area/deathmatch)
"EB" = (
/obj/structure/lattice/catwalk,
/obj/structure/marker_beacon/burgundy,
/turf/open/space/basic,
/area/deathmatch)
"FP" = (
/obj/machinery/door/airlock/survival_pod/glass,
/obj/effect/mapping_helpers/airlock/cyclelink_helper{
	dir = 8
	},
/turf/open/floor/grass,
/area/deathmatch)
"FS" = (
/obj/machinery/door/airlock/survival_pod/glass{
	dir = 4
	},
/obj/effect/mapping_helpers/airlock/cyclelink_helper{
	dir = 1
	},
/turf/open/floor/grass,
/area/deathmatch)
"FT" = (
/obj/structure/sign/nanotrasen{
	pixel_y = -32
	},
/turf/open/space/basic,
/area/deathmatch)
"Gu" = (
/obj/structure/lattice,
/obj/machinery/light/broken/directional/north,
/turf/open/space/basic,
/area/deathmatch)
"Hc" = (
/mob/living/basic/carp,
/turf/open/space/basic,
/area/deathmatch)
"HA" = (
/obj/structure/flora/rock/pile/icy/style_random,
/turf/open/misc/asteroid/airless,
/area/deathmatch)
"HI" = (
/obj/machinery/power/shuttle_engine/propulsion/right{
	dir = 4
	},
/obj/effect/turf_decal/stripes/line{
	dir = 4
	},
/turf/open/floor/plating/airless,
/area/deathmatch)
"HZ" = (
/obj/structure/sign/warning/directional/east,
/turf/open/space/basic,
/area/deathmatch)
"IG" = (
/obj/structure/water_source/puddle,
/obj/structure/flora/bush/reed/style_random,
/turf/open/floor/grass,
/area/deathmatch)
"Kh" = (
/mob/living/simple_animal/pet/gondola,
/turf/open/floor/grass,
/area/deathmatch)
"KJ" = (
/obj/structure/chair/comfy/shuttle/tactical{
	dir = 8
	},
/obj/effect/light_emitter{
	set_cap = 2;
	light_color = "#DEEFFF";
	set_luminosity = 4
	},
/obj/effect/landmark/deathmatch_player_spawn,
/turf/open/floor/mineral/plastitanium,
/area/deathmatch)
"KN" = (
/obj/structure/barricade/wooden,
/turf/open/misc/asteroid/airless,
/area/deathmatch)
"LV" = (
/obj/structure/flora/bush/flowers_yw/style_random,
/turf/open/floor/grass,
/area/deathmatch)
"Nc" = (
/obj/machinery/camera,
/turf/open/space/basic,
/area/deathmatch)
"NS" = (
/mob/living/simple_animal/pet/gondola,
/obj/effect/light_emitter{
	set_cap = 2;
	light_color = "#DEEFFF";
	set_luminosity = 4
	},
/turf/open/floor/grass,
/area/deathmatch)
"Ov" = (
/obj/effect/spawner/structure/window/reinforced/plasma/plastitanium,
/turf/open/floor/plating,
/area/deathmatch)
"OL" = (
/mob/living/basic/creature,
/turf/open/misc/asteroid,
/area/deathmatch)
"PM" = (
/obj/structure/table/reinforced,
/obj/machinery/recharger,
/obj/machinery/light/directional/south,
/turf/open/floor/iron,
/area/deathmatch)
"Qt" = (
/turf/open/floor/iron/half{
	dir = 8
	},
/area/deathmatch)
"Rm" = (
/obj/structure/sign/warning/directional/south,
/turf/open/space/basic,
/area/deathmatch)
"RV" = (
/obj/structure/lattice,
/turf/open/space/basic,
/area/deathmatch)
"SJ" = (
/turf/cordon,
/area/template_noop)
"Uz" = (
/turf/open/floor/iron,
/area/deathmatch)
"VN" = (
/turf/open/floor/grass,
/area/deathmatch)
"WA" = (
/obj/structure/marker_beacon/burgundy,
/turf/open/misc/asteroid/airless,
/area/deathmatch)
"Xf" = (
/turf/open/floor/iron/corner{
	dir = 4
	},
/area/deathmatch)
"XI" = (
/obj/structure/flora/bush/flowers_br/style_random,
/mob/living/simple_animal/pet/gondola,
/turf/open/floor/grass,
/area/deathmatch)
"Yo" = (
/obj/machinery/light/floor/broken,
/obj/effect/light_emitter{
	set_cap = 2;
	light_color = "#DEEFFF";
	set_luminosity = 4
	},
/turf/open/floor/plating,
/area/deathmatch)
"YJ" = (
/obj/machinery/door/airlock/external,
/turf/open/floor/mineral/plastitanium,
/area/deathmatch)
"ZK" = (
/turf/open/misc/asteroid/airless,
/area/deathmatch)

(1,1,1) = {"
SJ
SJ
SJ
SJ
SJ
SJ
SJ
SJ
SJ
SJ
SJ
SJ
SJ
SJ
SJ
SJ
SJ
SJ
SJ
SJ
SJ
SJ
SJ
SJ
SJ
SJ
SJ
SJ
SJ
SJ
mL
mL
mL
mL
mL
mL
mL
mL
mL
mL
"}
(2,1,1) = {"
SJ
wf
wf
wf
wf
wf
wf
wf
wf
wf
wf
wf
wf
wf
wf
wf
wf
wf
wf
wf
wf
wf
wf
wf
wf
wf
wf
wf
wf
wf
wf
wf
wf
wf
wf
wf
wf
wf
wf
mL
"}
(3,1,1) = {"
SJ
wf
wf
wf
wf
wf
wf
wf
wf
wf
wf
wf
wf
wf
wf
wf
wf
wf
wf
wf
wf
wf
wf
wf
wf
wf
wf
wf
wf
wf
wf
wf
wf
wf
wf
wf
wf
wf
wf
mL
"}
(4,1,1) = {"
SJ
wf
wf
wf
wf
wf
wf
wf
wf
wf
wf
wf
wf
wf
wf
wf
wf
wf
wf
wf
wf
wf
wf
wf
wf
wf
wf
wf
wf
wf
wf
wf
wf
wf
wf
wf
wf
wf
wf
mL
"}
(5,1,1) = {"
SJ
wf
wf
wf
wf
wf
wf
wf
wf
wf
wf
wf
wf
wf
wf
wf
wf
wf
wf
wf
wf
wf
wf
wf
wf
wf
wf
wf
wf
wf
wf
wf
wf
wf
wf
wf
wf
wf
wf
mL
"}
(6,1,1) = {"
SJ
wf
wf
wf
wf
wf
wf
wf
wf
wf
wf
wf
wf
wf
wf
wf
wf
wf
wf
wf
wf
wf
wf
wf
wf
wf
wf
wf
wf
wf
wf
wf
wf
wf
wf
wf
wf
wf
wf
mL
"}
(7,1,1) = {"
SJ
wf
wf
wf
wf
wf
wf
wf
wf
wf
wf
wf
wf
wf
wf
wf
wf
wf
wf
wf
wf
wf
wf
wf
wf
wf
wf
wf
wf
wf
wf
wf
wf
wf
wf
wf
wf
wf
wf
mL
"}
(8,1,1) = {"
SJ
wf
wf
wf
wf
wf
wf
wf
wf
wf
wf
wf
wf
wf
wf
wf
wf
wf
wf
wf
wf
wf
wf
wf
wf
wf
wf
wf
wf
wf
wf
wf
wf
wf
wf
wf
wf
wf
wf
mL
"}
(9,1,1) = {"
SJ
wf
wf
wf
wf
wf
wf
wf
wf
wf
wf
wf
wf
wf
wf
wf
wf
wf
wf
wf
wf
wf
wf
wf
wf
wf
wf
wf
wf
wf
wf
wf
wf
wf
wf
wf
wf
wf
wf
mL
"}
(10,1,1) = {"
SJ
wf
wf
wf
wf
wf
wf
wf
wf
wf
wf
wf
wf
wf
wf
wf
wf
wf
wf
wf
wf
wf
wf
wf
wf
wf
wf
wf
wf
wf
wf
wf
wf
wf
wf
wf
wf
wf
wf
mL
"}
(11,1,1) = {"
SJ
wf
wf
wf
wf
wf
wf
wf
wf
wf
wf
wf
wf
wf
wf
wf
wf
wf
wf
wf
wf
wf
wf
wf
wf
wf
wf
wf
wf
wf
wf
wf
wf
wf
wf
wf
wf
wf
wf
mL
"}
(12,1,1) = {"
SJ
wf
wf
wf
wf
wf
wf
wf
wf
wf
wf
wf
wf
wf
wf
wf
wf
wf
wf
wf
wf
wf
wf
wf
wf
wf
wf
wf
wf
wf
wf
wf
wf
wf
wf
wf
wf
wf
wf
mL
"}
(13,1,1) = {"
SJ
wf
wf
wf
wf
wf
wf
wf
wf
wf
wf
wf
wf
wf
wf
wf
wf
wf
wf
wf
wf
wf
wf
wf
wf
wf
wf
wf
wf
wf
wf
wf
wf
wf
wf
wf
wf
wf
wf
mL
"}
(14,1,1) = {"
SJ
wf
wf
wf
wf
wf
wf
wf
wf
wf
wf
wf
wf
wf
wf
wf
wf
wf
wf
wf
wf
wf
wf
wf
wf
wf
wf
wf
wf
wf
wf
wf
wf
wf
wf
wf
wf
wf
wf
mL
"}
(15,1,1) = {"
SJ
wf
wf
wf
wf
wf
wf
wf
wf
wf
wf
wf
wf
wf
wf
wf
wf
wf
wf
wf
wf
wf
wf
wf
wf
wf
wf
wf
wf
wf
wf
wf
wf
wf
wf
wf
wf
wf
wf
mL
"}
(16,1,1) = {"
SJ
wf
wf
wf
wf
wf
wf
wf
wf
wf
wf
wf
wf
wf
wf
wf
wf
wf
wf
wf
wf
wf
wf
wf
wf
wf
wf
wf
wf
wf
wf
wf
wf
wf
wf
wf
wf
wf
wf
mL
"}
(17,1,1) = {"
SJ
wf
wf
wf
wf
wf
wf
wf
wf
wf
wf
wf
wf
wf
wf
wf
wf
wf
wf
wf
wf
wf
wf
wf
wf
wf
wf
wf
wf
wf
wf
wf
wf
wf
wf
wf
wf
wf
wf
mL
"}
(18,1,1) = {"
SJ
wf
wf
wf
wf
wf
wf
wf
wf
wf
wf
wf
wf
wf
wf
wf
wf
wf
wf
wf
wf
wf
wf
wf
wf
wf
wf
wf
wf
wf
wf
wf
wf
wf
wf
wf
wf
wf
wf
mL
"}
(19,1,1) = {"
SJ
wf
wf
wf
wf
wf
wf
wf
wf
wf
wf
wf
wf
wf
wf
wf
wf
wf
wf
wf
wf
wf
wf
wf
wf
wf
wf
wf
wf
wf
wf
wf
wf
wf
wf
wf
wf
wf
wf
mL
"}
(20,1,1) = {"
SJ
wf
wf
wf
wf
wf
wf
wf
wf
wf
wf
wf
wf
wf
wf
wf
wf
wf
wf
wf
RV
wf
wf
wf
wf
wf
wf
wf
wf
wf
wf
wf
wf
wf
wf
wf
wf
wf
wf
mL
"}
(21,1,1) = {"
SJ
wf
wf
wf
wf
wf
wf
wf
wf
wf
wf
wf
wf
wf
wf
wf
wf
wf
fG
ip
ip
wf
wf
wf
wf
wf
wf
wf
wf
wf
wf
wf
wf
wf
wf
wf
wf
wf
wf
mL
"}
(22,1,1) = {"
SJ
wf
wf
wf
wf
wf
wf
wf
wf
wf
wf
wf
wf
wf
wf
wf
wf
wf
ip
fs
qg
aG
wf
wf
wf
wf
wf
wf
wf
wf
wf
wf
wf
wf
wf
wf
wf
wf
wf
mL
"}
(23,1,1) = {"
SJ
wf
wf
wf
wf
wf
wf
wf
wf
wf
wf
wf
wf
wf
wf
wf
wf
El
vB
qg
El
wf
wf
wf
wf
wf
wf
wf
wf
wf
wf
wf
wf
wf
wf
wf
wf
wf
wf
mL
"}
(24,1,1) = {"
SJ
wf
wf
wf
wf
wf
wf
wf
wf
wf
wf
wf
wf
wf
wf
wf
wf
yB
ip
yB
wf
wf
wf
wf
wf
wf
wf
wf
wf
wf
wf
wf
wf
wf
wf
wf
wf
wf
wf
SJ
"}
(25,1,1) = {"
SJ
wf
wf
wf
wf
wf
wf
wf
wf
wf
wf
wf
wf
wf
wf
wf
qg
qg
vB
qg
qg
CW
wf
wf
wf
wf
wf
wf
wf
wf
wf
wf
wf
wf
wf
wf
wf
wf
Hc
SJ
"}
(26,1,1) = {"
SJ
wf
wf
wf
wf
wf
wf
wf
wf
wf
wf
wf
wf
wf
wf
Nc
qg
lf
Uz
CT
qg
wf
wf
wf
wf
wf
wf
wf
wf
wf
wf
wf
wf
wf
wf
wf
wf
ne
wf
SJ
"}
(27,1,1) = {"
SJ
wf
wf
wf
wf
wf
wf
wf
wf
wf
wf
wf
wf
wf
wf
wf
tc
rg
Qt
Xf
tc
wf
wf
wf
wf
wf
wf
wf
wf
wf
wf
wf
wf
wf
wf
wf
ne
wf
Hc
SJ
"}
(28,1,1) = {"
SJ
wf
wf
wf
wf
wf
wf
wf
wf
wf
wf
wf
wf
wf
wf
wf
tc
mq
CV
mq
tc
wf
wf
wf
yg
Ov
yg
wf
wf
wf
wf
wf
wf
wf
wf
wf
wf
wf
wf
SJ
"}
(29,1,1) = {"
SJ
ZK
qw
ah
qw
wf
wf
wf
wf
wf
wf
wf
wf
wf
wf
wf
tc
ll
Qt
bN
tc
wf
wf
wf
hH
eb
og
wf
wf
wf
wf
wf
wf
wf
wf
wf
wf
wf
wf
SJ
"}
(30,1,1) = {"
Eb
qw
qw
VN
qw
ZK
wf
wf
wf
wf
wf
wf
wf
wf
wf
wf
qg
Ar
Uz
PM
qg
aG
wf
yg
yg
KJ
yg
yg
wf
wf
wf
wf
wf
wf
wf
wf
wf
wf
ZK
ir
"}
(31,1,1) = {"
Eb
qw
qw
FP
qw
qw
ZK
wf
wf
wf
wf
wf
wf
wf
wf
FT
qg
qg
vB
qg
qg
wf
wf
cT
yg
YJ
yg
cT
wf
wf
wf
wf
wf
rN
HA
wf
wf
ZK
HA
ir
"}
(32,1,1) = {"
Eb
qw
Kh
LV
qw
qw
qw
wf
wf
wf
wf
wf
wf
wf
wf
wf
wf
yB
ip
yB
wf
wf
wf
HI
cT
ys
cT
HI
wf
wf
wf
wf
rN
rN
rN
wf
wf
ZK
rN
ir
"}
(33,1,1) = {"
Eb
zj
xM
VN
XI
qw
qw
wf
wf
wf
rN
ZK
EB
wf
wf
wf
qg
qg
vB
qg
El
wf
wf
wf
HI
wf
HI
wf
wf
wf
wf
wf
rN
rN
rN
wf
ZK
dH
rN
ir
"}
(34,1,1) = {"
Eb
bW
VN
IG
xM
qw
qw
wf
wf
rN
rN
ZK
vn
ys
wf
Nc
qg
is
ip
Uz
El
wf
wf
wf
wf
wf
wf
wf
wf
wf
wf
wf
wf
rN
wf
wf
ZK
KN
ZK
ir
"}
(35,1,1) = {"
Eb
oi
VN
VN
bW
qw
qw
ZK
wf
rN
rN
ZK
ZK
ys
wf
wf
Bh
kK
vy
ip
Bh
wf
wf
ZK
wf
wf
ZK
ZK
wf
ZK
wf
wf
wf
wf
wf
wf
ZK
dH
ZK
ir
"}
(36,1,1) = {"
Eb
xM
NS
zj
LV
qw
qw
qw
wf
wf
rN
ZK
ZK
sy
wf
wf
ip
ip
Yo
RV
ip
wf
wf
wf
wf
ZK
qw
HA
ZK
ZK
ZK
wf
wf
wf
wf
ZK
rN
rN
ZK
ir
"}
(37,1,1) = {"
Eb
VN
zj
xM
VN
dx
VN
FS
wf
wf
rN
rN
WA
ys
wf
wf
ip
RV
ip
wf
wf
wf
ZK
HZ
ZK
qw
qw
qw
qw
ep
ZK
ZK
wf
wf
ZK
rN
rN
kO
wi
ir
"}
(38,1,1) = {"
Eb
VN
bW
oi
zj
qw
qw
qw
wf
wf
wf
rN
ZK
wf
wf
wf
El
Gu
wf
wf
wf
wf
Rm
dH
qw
qw
qw
qw
qw
dH
ry
wi
ZK
wf
ZK
rN
rN
HA
el
ir
"}
(39,1,1) = {"
Eb
LV
xM
VN
qw
qw
qw
ZK
wf
wf
wf
wf
wf
wf
wf
wf
RV
El
wf
wf
wf
wf
qw
qw
qw
qw
OL
qw
qw
qw
qw
ZK
wf
wf
HA
rN
rN
rN
rN
ir
"}
(40,1,1) = {"
Eb
Eb
Eb
Eb
Eb
Eb
Eb
SJ
SJ
SJ
SJ
SJ
SJ
SJ
SJ
SJ
SJ
SJ
SJ
SJ
SJ
SJ
Eb
Eb
Eb
Eb
Eb
Eb
Eb
Eb
Eb
Eb
SJ
SJ
ir
ir
ir
ir
ir
ir
"}
