//MAP CONVERTED BY dmm2tgm.py THIS HEADER COMMENT PREVENTS RECONVERSION, DO NOT REMOVE
"a" = (
/turf/open/floor/plating/elevatorshaft,
/area/station/maintenance/central/greater)
"b" = (
/turf/open/floor/noslip/tram,
/area/station/hallway/secondary/entry)
"c" = (
/obj/structure/fluff/tram_rail/electric{
	dir = 1
	},
/obj/structure/transport/linear/tram,
/obj/structure/thermoplastic,
/obj/structure/chair/sofa/bench/tram/right{
	dir = 1
	},
/turf/open/floor/plating/elevatorshaft,
/area/station/maintenance/central/greater)
"d" = (
/obj/structure/transport/linear/tram,
/obj/structure/tram/split,
/obj/machinery/transport/destination_sign/split/north,
/turf/open/floor/plating/elevatorshaft,
/area/station/maintenance/central/greater)
"e" = (
/obj/structure/fluff/tram_rail/end{
	dir = 4
	},
/obj/structure/transport/linear/tram,
/obj/structure/tram,
/turf/open/floor/plating/elevatorshaft,
/area/station/maintenance/central/greater)
"f" = (
/obj/structure/fluff/tram_rail/electric,
/obj/structure/transport/linear/tram,
/obj/structure/thermoplastic,
/obj/structure/chair/sofa/bench/tram/right,
/turf/open/floor/plating/elevatorshaft,
/area/station/maintenance/central/greater)
"g" = (
/obj/effect/turf_decal/tile/neutral/tram,
/obj/structure/transport/linear/tram,
/obj/structure/thermoplastic,
/obj/structure/chair/sofa/bench/tram/left{
	dir = 4
	},
/turf/open/floor/plating/elevatorshaft,
/area/station/maintenance/central/greater)
"h" = (
/obj/structure/fluff/tram_rail/electric,
/turf/open/floor/plating/elevatorshaft,
/area/station/maintenance/central/greater)
"i" = (
/obj/structure/transport/linear/tram,
/obj/structure/tram,
/obj/machinery/transport/tram_controller,
/turf/open/floor/plating/elevatorshaft,
/area/station/maintenance/central/greater)
"j" = (
/obj/structure/transport/linear/tram/corner/southwest,
/obj/structure/tram/spoiler,
/turf/open/floor/plating/elevatorshaft,
/area/station/maintenance/central/greater)
"k" = (
/obj/machinery/transport/guideway_sensor,
/turf/open/floor/plating,
/area/station/maintenance/central/greater)
"l" = (
/obj/effect/turf_decal/tile/neutral/tram,
/obj/structure/transport/linear/tram,
/obj/effect/landmark/transport/nav_beacon/tram/platform/tramstation/west,
/obj/structure/thermoplastic/light,
/obj/effect/landmark/transport/nav_beacon/tram/nav/tramstation/main,
/turf/open/floor/plating/elevatorshaft,
/area/station/maintenance/central/greater)
"m" = (
/obj/structure/transport/linear/tram,
/obj/structure/tram,
/turf/open/floor/plating/elevatorshaft,
/area/station/maintenance/central/greater)
"n" = (
/obj/structure/fluff/tram_rail/electric{
	dir = 1
	},
/obj/structure/transport/linear/tram,
/obj/structure/thermoplastic/light,
/turf/open/floor/plating/elevatorshaft,
/area/station/maintenance/central/greater)
"o" = (
/obj/structure/fluff/tram_rail/electric{
	dir = 1
	},
/obj/structure/transport/linear/tram,
/obj/structure/thermoplastic,
/obj/structure/chair/sofa/bench/tram/left{
	dir = 1
	},
/obj/machinery/computer/tram_controls/split/directional/south,
/turf/open/floor/plating/elevatorshaft,
/area/station/maintenance/central/greater)
"p" = (
/obj/structure/transport/linear/tram,
/obj/structure/thermoplastic/light,
/obj/machinery/door/airlock/tram,
/turf/open/floor/plating/elevatorshaft,
/area/station/maintenance/central/greater)
"q" = (
/obj/structure/fluff/tram_rail/end{
	dir = 8
	},
/obj/structure/transport/linear/tram,
/obj/structure/tram,
/turf/open/floor/plating/elevatorshaft,
/area/station/maintenance/central/greater)
"s" = (
/obj/structure/fluff/tram_rail/electric{
	dir = 1
	},
/turf/open/floor/plating/elevatorshaft,
/area/station/maintenance/central/greater)
"t" = (
/obj/structure/fluff/tram_rail,
/obj/structure/transport/linear/tram,
/obj/structure/thermoplastic,
/obj/structure/chair/sofa/bench/tram/right,
/turf/open/floor/plating/elevatorshaft,
/area/station/maintenance/central/greater)
"u" = (
/obj/structure/transport/linear/tram,
/obj/structure/thermoplastic/light,
/turf/open/floor/plating/elevatorshaft,
/area/station/maintenance/central/greater)
"v" = (
/obj/structure/fluff/tram_rail/electric,
/obj/structure/transport/linear/tram,
/obj/structure/tram,
/turf/open/floor/plating/elevatorshaft,
/area/station/maintenance/central/greater)
"w" = (
/obj/structure/fluff/tram_rail/electric,
/obj/structure/transport/linear/tram,
/obj/structure/thermoplastic,
/obj/structure/chair/sofa/bench/tram/left,
/turf/open/floor/plating/elevatorshaft,
/area/station/maintenance/central/greater)
"y" = (
/obj/structure/fluff/tram_rail/electric{
	dir = 1
	},
/obj/structure/transport/linear/tram,
/obj/structure/thermoplastic,
/obj/structure/chair/sofa/bench/tram/right{
	dir = 4
	},
/turf/open/floor/plating/elevatorshaft,
/area/station/maintenance/central/greater)
"z" = (
/obj/structure/fluff/tram_rail/electric,
/obj/structure/transport/linear/tram,
/obj/structure/thermoplastic/light,
/obj/machinery/computer/tram_controls/split/directional/north,
/turf/open/floor/plating/elevatorshaft,
/area/station/maintenance/central/greater)
"A" = (
/turf/open/floor/plating,
/area/station/maintenance/central/greater)
"C" = (
/obj/structure/fluff/tram_rail/electric{
	dir = 1
	},
/obj/structure/transport/linear/tram,
/obj/structure/thermoplastic,
/obj/structure/chair/sofa/bench/tram/left{
	dir = 8
	},
/turf/open/floor/plating/elevatorshaft,
/area/station/maintenance/central/greater)
"D" = (
/obj/effect/turf_decal/tile/neutral/tram,
/obj/effect/landmark/transport/transport_id/tramstation/line_1,
/obj/structure/transport/linear/tram,
/obj/structure/thermoplastic/light,
/turf/open/floor/plating/elevatorshaft,
/area/station/maintenance/central/greater)
"E" = (
/obj/structure/fluff/tram_rail/electric/anchor,
/obj/structure/transport/linear/tram,
/obj/structure/thermoplastic/light,
/turf/open/floor/plating/elevatorshaft,
/area/station/maintenance/central/greater)
"F" = (
/obj/structure/transport/linear/tram,
/obj/structure/tram,
/obj/structure/plaque/static_plaque/tram,
/turf/open/floor/plating/elevatorshaft,
/area/station/maintenance/central/greater)
"H" = (
/turf/open/floor/tram/plate,
/area/station/maintenance/central/greater)
"I" = (
/obj/structure/transport/linear/tram,
/obj/structure/tram/split,
/turf/open/floor/plating/elevatorshaft,
/area/station/maintenance/central/greater)
"J" = (
/obj/structure/fluff/tram_rail/electric/anchor{
	dir = 1
	},
/obj/structure/transport/linear/tram,
/obj/structure/thermoplastic,
/obj/structure/chair/sofa/bench/tram{
	dir = 1
	},
/turf/open/floor/plating/elevatorshaft,
/area/station/maintenance/central/greater)
"L" = (
/obj/structure/transport/linear/tram/corner/northwest,
/obj/structure/tram/spoiler{
	dir = 8
	},
/turf/open/floor/plating/elevatorshaft,
/area/station/maintenance/central/greater)
"M" = (
/turf/template_noop,
/area/template_noop)
"N" = (
/obj/effect/turf_decal/tile/neutral/tram,
/obj/structure/transport/linear/tram,
/obj/structure/thermoplastic/light,
/turf/open/floor/plating/elevatorshaft,
/area/station/maintenance/central/greater)
"O" = (
/obj/effect/turf_decal/tile/neutral/tram,
/obj/structure/transport/linear/tram,
/obj/structure/tram,
/turf/open/floor/plating/elevatorshaft,
/area/station/maintenance/central/greater)
"P" = (
/turf/closed/wall,
/area/station/maintenance/central/greater)
"Q" = (
/obj/machinery/transport/destination_sign/indicator/directional,
/obj/machinery/button/transport/tram/directional{
	id = 1
	},
/turf/closed/wall,
/area/station/hallway/secondary/entry)
"R" = (
/obj/effect/turf_decal/tile/neutral/tram,
/obj/structure/transport/linear/tram,
/obj/structure/thermoplastic,
/obj/structure/chair/sofa/bench/tram/right{
	dir = 8
	},
/turf/open/floor/plating/elevatorshaft,
/area/station/maintenance/central/greater)
"S" = (
/obj/structure/cable,
/obj/machinery/atmospherics/pipe/smart/manifold4w/scrubbers/hidden/layer2,
/obj/machinery/atmospherics/pipe/smart/manifold4w/supply/hidden/layer4,
/turf/open/floor/plating,
/area/station/maintenance/central/greater)
"T" = (
/obj/structure/transport/linear/tram/corner/southeast,
/obj/structure/tram/spoiler{
	dir = 4
	},
/turf/open/floor/plating/elevatorshaft,
/area/station/maintenance/central/greater)
"U" = (
/obj/structure/transport/linear/tram/corner/northeast,
/obj/structure/tram/spoiler{
	dir = 1
	},
/turf/open/floor/plating/elevatorshaft,
/area/station/maintenance/central/greater)
"V" = (
/obj/structure/fluff/tram_rail/electric,
/obj/structure/transport/linear/tram,
/obj/structure/thermoplastic,
/turf/open/floor/plating/elevatorshaft,
/area/station/maintenance/central/greater)
"W" = (
/obj/structure/fluff/tram_rail/electric{
	dir = 1
	},
/obj/structure/transport/linear/tram,
/obj/structure/tram,
/turf/open/floor/plating/elevatorshaft,
/area/station/maintenance/central/greater)
"X" = (
/obj/structure/fluff/tram_rail/electric,
/obj/structure/transport/linear/tram,
/obj/structure/thermoplastic/light,
/turf/open/floor/plating/elevatorshaft,
/area/station/maintenance/central/greater)
"Y" = (
/obj/structure/transport/linear/tram,
/obj/structure/tram/split,
/obj/machinery/transport/destination_sign/split/south,
/turf/open/floor/plating/elevatorshaft,
/area/station/maintenance/central/greater)
"Z" = (
/obj/machinery/transport/guideway_sensor{
	dir = 1
	},
/turf/open/floor/plating,
/area/station/maintenance/central/greater)

(1,1,1) = {"
M
M
M
M
M
M
M
M
M
M
M
"}
(2,1,1) = {"
M
M
M
M
M
L
q
O
e
j
Q
"}
(3,1,1) = {"
M
M
M
M
M
i
V
g
y
m
b
"}
(4,1,1) = {"
M
M
M
M
P
m
f
N
n
p
b
"}
(5,1,1) = {"
M
M
M
M
P
m
w
N
n
u
b
"}
(6,1,1) = {"
M
M
M
M
P
I
X
D
o
Y
b
"}
(7,1,1) = {"
M
M
M
M
M
I
E
l
J
I
b
"}
(8,1,1) = {"
M
M
M
M
M
d
z
N
c
I
b
"}
(9,1,1) = {"
M
M
M
M
M
m
t
N
n
p
b
"}
(10,1,1) = {"
M
M
M
M
P
m
w
N
n
u
b
"}
(11,1,1) = {"
M
M
M
M
P
F
V
R
C
m
Q
"}
(12,1,1) = {"
M
M
M
M
P
U
v
O
W
T
P
"}
(13,1,1) = {"
M
M
M
M
P
a
h
H
s
a
S
"}
(14,1,1) = {"
M
M
M
M
P
a
h
H
s
a
S
"}
(15,1,1) = {"
M
M
M
M
P
a
h
H
s
a
S
"}
(16,1,1) = {"
M
M
M
M
P
a
h
H
s
a
S
"}
(17,1,1) = {"
M
M
M
M
P
a
h
H
s
a
S
"}
(18,1,1) = {"
M
M
M
M
P
a
h
H
s
a
S
"}
(19,1,1) = {"
M
M
M
M
P
a
h
H
s
a
A
"}
(20,1,1) = {"
M
M
M
M
P
a
h
H
s
a
A
"}
(21,1,1) = {"
M
M
M
M
P
a
h
H
s
a
A
"}
(22,1,1) = {"
M
M
M
M
P
a
h
H
s
a
A
"}
(23,1,1) = {"
M
M
M
M
P
a
h
H
s
a
A
"}
(24,1,1) = {"
M
M
M
M
P
a
h
H
s
a
A
"}
(25,1,1) = {"
M
M
M
M
P
a
h
H
s
a
A
"}
(26,1,1) = {"
M
M
M
M
P
a
h
H
s
a
A
"}
(27,1,1) = {"
M
M
M
M
P
a
h
H
s
a
A
"}
(28,1,1) = {"
M
M
M
M
k
a
h
H
s
a
Z
"}
