//MAP CONVERTED BY dmm2tgm.py THIS HEADER COMMENT PREVENTS RECONVERSION, DO NOT REMOVE
"a" = (
/turf/template_noop,
/area/template_noop)
"b" = (
/obj/machinery/button/curtain{
	id = "barbershopcurtains";
	pixel_y = -24
	},
/turf/open/floor/iron/dark/smooth_corner{
	dir = 1
	},
/area/station/service/barber)
"c" = (
/obj/machinery/door/airlock/public/glass{
	name = "Barbershop"
	},
/obj/machinery/atmospherics/pipe/smart/manifold4w/supply/hidden/layer4,
/obj/machinery/atmospherics/pipe/smart/manifold4w/scrubbers/hidden/layer2,
/obj/structure/cable,
/obj/machinery/door/firedoor,
/obj/effect/landmark/navigate_destination{
	location = "Barbershop"
	},
/turf/open/floor/wood/parquet,
/area/station/service/barber)
"d" = (
/obj/machinery/atmospherics/components/unary/vent_pump/on/layer4{
	dir = 4
	},
/obj/effect/landmark/start/barber,
/turf/open/floor/iron/dark/smooth_large,
/area/station/service/barber)
"g" = (
/obj/structure/table/glass,
/obj/item/hairbrush/comb{
	pixel_y = 16;
	pixel_x = 0
	},
/obj/item/reagent_containers/spray/quantum_hair_dye{
	pixel_x = -9;
	pixel_y = 14
	},
/obj/item/reagent_containers/spray/barbers_aid{
	pixel_x = 1;
	pixel_y = 12
	},
/obj/item/razor{
	pixel_x = 10;
	pixel_y = 6
	},
/obj/machinery/light/small/directional/west,
/obj/item/radio/intercom/directional/west,
/turf/open/floor/iron/dark/smooth_edge{
	dir = 4
	},
/area/station/service/barber)
"j" = (
/obj/effect/turf_decal/tile/neutral,
/obj/machinery/atmospherics/pipe/smart/manifold4w/supply/hidden/layer4,
/obj/machinery/atmospherics/pipe/smart/manifold4w/scrubbers/hidden/layer2,
/obj/structure/cable,
/turf/open/floor/iron,
/area/station/hallway/primary/central)
"k" = (
/obj/effect/turf_decal/siding/wood{
	dir = 8
	},
/obj/structure/closet/secure_closet/barber,
/turf/open/floor/wood/parquet,
/area/station/service/barber)
"l" = (
/obj/structure/chair/comfy/barber_chair{
	dir = 8
	},
/obj/machinery/firealarm/directional/south,
/turf/open/floor/iron/dark/smooth_edge{
	dir = 1
	},
/area/station/service/barber)
"p" = (
/obj/machinery/atmospherics/pipe/smart/manifold4w/scrubbers/hidden/layer2,
/obj/machinery/atmospherics/pipe/smart/manifold4w/supply/hidden/layer4,
/obj/structure/cable,
/obj/effect/landmark/start/barber,
/turf/open/floor/wood/parquet,
/area/station/service/barber)
"s" = (
/obj/machinery/vending/barbervend,
/obj/machinery/camera/autoname/directional/east,
/turf/open/floor/wood/parquet,
/area/station/service/barber)
"t" = (
/obj/machinery/atmospherics/pipe/smart/manifold4w/scrubbers/hidden/layer2,
/obj/machinery/atmospherics/pipe/smart/manifold4w/supply/hidden/layer4,
/turf/open/floor/iron/dark/smooth_edge{
	dir = 8
	},
/area/station/service/barber)
"x" = (
/obj/structure/table/glass,
/obj/structure/mirror/directional/west,
/turf/open/floor/iron/dark/smooth_corner{
	dir = 4
	},
/area/station/service/barber)
"y" = (
/obj/effect/turf_decal/siding/wood{
	dir = 8
	},
/obj/machinery/atmospherics/pipe/smart/manifold4w/scrubbers/hidden/layer2,
/obj/machinery/atmospherics/pipe/smart/manifold4w/supply/hidden/layer4,
/turf/open/floor/wood/parquet,
/area/station/service/barber)
"A" = (
/obj/machinery/door/airlock/maintenance,
/obj/effect/mapping_helpers/airlock/access/all/engineering/maintenance,
/obj/effect/turf_decal/siding/wood{
	dir = 4
	},
/turf/open/floor/wood/parquet,
/area/station/service/barber)
"C" = (
/obj/effect/turf_decal/siding/wood{
	dir = 8
	},
/obj/machinery/airalarm/directional/north,
/obj/machinery/atmospherics/pipe/smart/manifold4w/scrubbers/hidden/layer2,
/obj/machinery/atmospherics/pipe/smart/manifold4w/supply/hidden/layer4,
/obj/item/kirbyplants/organic/plant3,
/obj/machinery/light/small/directional/north,
/turf/open/floor/wood/parquet,
/area/station/service/barber)
"H" = (
/obj/structure/chair/comfy/barber_chair{
	dir = 8
	},
/turf/open/floor/iron/dark/smooth_edge,
/area/station/service/barber)
"I" = (
/obj/machinery/light_switch/directional/south{
	pixel_x = -8
	},
/obj/machinery/holopad,
/obj/effect/landmark/start/barber,
/turf/open/floor/wood/parquet,
/area/station/service/barber)
"K" = (
/turf/open/floor/iron/dark/smooth_corner{
	dir = 8
	},
/area/station/service/barber)
"M" = (
/obj/machinery/power/apc/auto_name/directional/south,
/obj/machinery/atmospherics/components/unary/vent_scrubber/on/layer2{
	dir = 8
	},
/obj/structure/cable,
/turf/open/floor/wood/parquet,
/area/station/service/barber)
"P" = (
/turf/closed/wall,
/area/station/service/barber)
"Q" = (
/obj/structure/table/glass,
/obj/structure/mirror/directional/west,
/turf/open/floor/iron/dark/smooth_corner,
/area/station/service/barber)
"Y" = (
/obj/effect/spawner/structure/window,
/obj/structure/curtain/cloth/fancy/mechanical{
	id = "barbershopcurtains"
	},
/turf/open/floor/plating,
/area/station/service/barber)

(1,1,1) = {"
a
Y
Q
g
x
P
"}
(2,1,1) = {"
a
Y
H
d
l
P
"}
(3,1,1) = {"
a
Y
K
t
b
P
"}
(4,1,1) = {"
a
P
C
y
k
P
"}
(5,1,1) = {"
j
c
p
M
P
P
"}
(6,1,1) = {"
a
P
s
I
P
a
"}
(7,1,1) = {"
a
P
P
A
P
a
"}
