//MAP CONVERTED BY dmm2tgm.py THIS HEADER COMMENT PREVENTS RECONVERSION, DO NOT REMOVE
"a" = (
/turf/open/floor/plating,
/area/station/hallway/secondary/entry)
"b" = (
/turf/open/floor/noslip/tram,
/area/station/hallway/secondary/entry)
"c" = (
/obj/structure/fluff/tram_rail/electric{
	dir = 1
	},
/obj/structure/transport/linear/tram,
/obj/structure/thermoplastic,
/obj/structure/chair/sofa/bench/tram/right{
	dir = 1
	},
/turf/open/floor/plating,
/area/station/hallway/secondary/entry)
"d" = (
/obj/structure/transport/linear/tram,
/obj/structure/tram/split,
/obj/machinery/transport/destination_sign/split/north,
/turf/open/floor/plating,
/area/station/hallway/secondary/entry)
"f" = (
/obj/structure/transport/linear/tram,
/obj/structure/tram,
/obj/structure/plaque/static_plaque/tram,
/turf/open/floor/plating,
/area/station/hallway/secondary/entry)
"g" = (
/obj/effect/turf_decal/tile/neutral/tram,
/obj/structure/transport/linear/tram,
/obj/structure/thermoplastic,
/obj/structure/chair/sofa/bench/tram/left{
	dir = 4
	},
/turf/open/indestructible/tram/plate,
/area/station/hallway/secondary/entry)
"h" = (
/obj/structure/fluff/tram_rail/electric,
/turf/open/floor/plating,
/area/station/hallway/secondary/entry)
"i" = (
/obj/structure/transport/linear/tram,
/obj/structure/tram,
/obj/machinery/transport/tram_controller,
/turf/open/floor/plating,
/area/station/hallway/secondary/entry)
"j" = (
/obj/structure/transport/linear/tram/corner/southwest,
/obj/structure/tram/spoiler,
/turf/open/floor/plating,
/area/station/hallway/secondary/entry)
"l" = (
/obj/effect/turf_decal/tile/neutral/tram,
/obj/structure/transport/linear/tram,
/obj/effect/landmark/transport/nav_beacon/tram/platform/tramstation/west,
/obj/structure/thermoplastic/light,
/turf/open/indestructible/tram/plate,
/area/station/hallway/secondary/entry)
"m" = (
/obj/structure/transport/linear/tram,
/obj/structure/thermoplastic/light,
/obj/machinery/door/airlock/tram,
/turf/open/openspace,
/area/station/hallway/secondary/entry)
"n" = (
/obj/structure/fluff/tram_rail/electric{
	dir = 1
	},
/obj/structure/transport/linear/tram,
/obj/structure/thermoplastic/light,
/turf/open/floor/plating,
/area/station/hallway/secondary/entry)
"o" = (
/obj/structure/fluff/tram_rail/electric{
	dir = 1
	},
/obj/structure/transport/linear/tram,
/obj/structure/thermoplastic,
/obj/structure/chair/sofa/bench/tram/left{
	dir = 1
	},
/obj/machinery/computer/tram_controls/split/directional/south,
/turf/open/floor/plating,
/area/station/hallway/secondary/entry)
"p" = (
/obj/structure/transport/linear/tram,
/obj/structure/thermoplastic/light,
/obj/machinery/door/airlock/tram,
/turf/open/floor/plating,
/area/station/hallway/secondary/entry)
"q" = (
/obj/effect/turf_decal/stripes/line{
	dir = 8
	},
/turf/open/floor/plating,
/area/station/hallway/secondary/entry)
"s" = (
/obj/structure/fluff/tram_rail/electric{
	dir = 1
	},
/turf/open/floor/plating,
/area/station/hallway/secondary/entry)
"t" = (
/obj/structure/fluff/tram_rail,
/obj/structure/transport/linear/tram,
/obj/structure/thermoplastic/light,
/turf/open/floor/plating,
/area/station/hallway/secondary/entry)
"u" = (
/obj/structure/transport/linear/tram,
/obj/structure/thermoplastic/light,
/turf/open/floor/plating,
/area/station/hallway/secondary/entry)
"v" = (
/obj/structure/fluff/tram_rail/electric,
/obj/structure/transport/linear/tram,
/obj/structure/tram,
/turf/open/floor/plating,
/area/station/hallway/secondary/entry)
"w" = (
/obj/structure/fluff/tram_rail/electric,
/obj/structure/transport/linear/tram,
/obj/structure/thermoplastic/light,
/turf/open/floor/plating,
/area/station/hallway/secondary/entry)
"y" = (
/obj/structure/fluff/tram_rail/electric{
	dir = 1
	},
/obj/structure/transport/linear/tram,
/obj/structure/thermoplastic,
/obj/structure/chair/sofa/bench/tram/right{
	dir = 4
	},
/turf/open/floor/plating,
/area/station/hallway/secondary/entry)
"z" = (
/obj/structure/fluff/tram_rail/electric,
/obj/structure/transport/linear/tram,
/obj/structure/thermoplastic,
/obj/structure/chair/sofa/bench/tram/left,
/obj/machinery/computer/tram_controls/split/directional/north,
/turf/open/floor/plating,
/area/station/hallway/secondary/entry)
"C" = (
/obj/structure/fluff/tram_rail/electric{
	dir = 1
	},
/obj/structure/transport/linear/tram,
/obj/structure/thermoplastic,
/turf/open/floor/plating,
/area/station/hallway/secondary/entry)
"D" = (
/obj/effect/turf_decal/tile/neutral/tram,
/obj/effect/landmark/transport/transport_id/tramstation/line_1,
/obj/structure/transport/linear/tram,
/obj/structure/thermoplastic/light,
/turf/open/indestructible/tram/plate,
/area/station/hallway/secondary/entry)
"E" = (
/obj/structure/fluff/tram_rail/electric/anchor,
/obj/structure/transport/linear/tram,
/obj/structure/thermoplastic,
/obj/structure/chair/sofa/bench/tram,
/turf/open/floor/plating,
/area/station/hallway/secondary/entry)
"F" = (
/obj/structure/transport/linear/tram,
/obj/structure/tram,
/turf/open/floor/plating,
/area/station/hallway/secondary/entry)
"H" = (
/turf/open/floor/tram/plate,
/area/station/hallway/secondary/entry)
"I" = (
/obj/structure/transport/linear/tram,
/obj/structure/tram/split,
/turf/open/floor/plating,
/area/station/hallway/secondary/entry)
"J" = (
/obj/structure/fluff/tram_rail/electric/anchor{
	dir = 1
	},
/obj/structure/transport/linear/tram,
/obj/structure/thermoplastic,
/obj/structure/chair/sofa/bench/tram{
	dir = 1
	},
/turf/open/floor/plating,
/area/station/hallway/secondary/entry)
"L" = (
/obj/structure/transport/linear/tram/corner/northwest,
/obj/structure/tram/spoiler{
	dir = 8
	},
/turf/open/floor/plating,
/area/station/hallway/secondary/entry)
"M" = (
/turf/template_noop,
/area/template_noop)
"N" = (
/obj/effect/turf_decal/tile/neutral/tram,
/obj/structure/transport/linear/tram,
/obj/structure/thermoplastic/light,
/turf/open/indestructible/tram/plate,
/area/station/hallway/secondary/entry)
"O" = (
/obj/effect/turf_decal/tile/neutral/tram,
/obj/structure/transport/linear/tram,
/obj/structure/tram,
/turf/open/indestructible/tram/plate,
/area/station/hallway/secondary/entry)
"P" = (
/turf/closed/wall,
/area/station/hallway/secondary/entry)
"Q" = (
/obj/machinery/transport/destination_sign/indicator/directional,
/obj/machinery/button/transport/tram/directional{
	id = 1
	},
/turf/closed/wall,
/area/station/hallway/secondary/entry)
"R" = (
/obj/effect/turf_decal/tile/neutral/tram,
/obj/structure/transport/linear/tram,
/obj/structure/thermoplastic,
/obj/structure/chair/sofa/bench/tram/left{
	dir = 8
	},
/turf/open/indestructible/tram/plate,
/area/station/hallway/secondary/entry)
"S" = (
/obj/structure/transport/linear/tram,
/obj/structure/thermoplastic/light,
/turf/open/openspace,
/area/station/hallway/secondary/entry)
"T" = (
/obj/structure/transport/linear/tram/corner/southeast,
/obj/structure/tram/spoiler{
	dir = 4
	},
/turf/open/floor/plating,
/area/station/hallway/secondary/entry)
"U" = (
/obj/structure/transport/linear/tram/corner/northeast,
/obj/structure/tram/spoiler{
	dir = 1
	},
/turf/open/floor/plating,
/area/station/hallway/secondary/entry)
"V" = (
/obj/structure/fluff/tram_rail/electric,
/obj/structure/transport/linear/tram,
/obj/structure/thermoplastic,
/obj/structure/chair/sofa/bench/tram/right{
	dir = 8
	},
/turf/open/floor/plating,
/area/station/hallway/secondary/entry)
"W" = (
/obj/structure/fluff/tram_rail/electric{
	dir = 1
	},
/obj/structure/transport/linear/tram,
/obj/structure/tram,
/turf/open/floor/plating,
/area/station/hallway/secondary/entry)
"X" = (
/obj/structure/fluff/tram_rail/electric,
/obj/structure/transport/linear/tram,
/obj/structure/thermoplastic,
/obj/structure/chair/sofa/bench/tram/right,
/turf/open/floor/plating,
/area/station/hallway/secondary/entry)
"Y" = (
/obj/structure/transport/linear/tram,
/obj/structure/tram/split,
/obj/machinery/transport/destination_sign/split/south,
/turf/open/floor/plating,
/area/station/hallway/secondary/entry)
"Z" = (
/obj/structure/fluff/tram_rail/electric,
/obj/structure/transport/linear/tram,
/obj/structure/thermoplastic,
/turf/open/floor/plating,
/area/station/hallway/secondary/entry)

(1,1,1) = {"
M
M
M
M
M
M
M
M
M
M
M
"}
(2,1,1) = {"
M
M
M
M
M
L
v
O
W
j
b
"}
(3,1,1) = {"
M
M
M
M
M
i
Z
g
y
F
b
"}
(4,1,1) = {"
M
M
M
M
P
p
w
N
n
p
b
"}
(5,1,1) = {"
M
M
M
M
P
u
w
N
n
u
b
"}
(6,1,1) = {"
M
M
M
M
P
I
X
D
o
Y
b
"}
(7,1,1) = {"
M
M
M
M
M
I
E
l
J
I
Q
"}
(8,1,1) = {"
M
M
M
M
M
d
z
N
c
I
b
"}
(9,1,1) = {"
M
M
M
M
M
m
t
N
n
p
b
"}
(10,1,1) = {"
M
M
M
M
P
u
w
N
n
S
b
"}
(11,1,1) = {"
M
M
M
M
P
F
V
R
C
f
b
"}
(12,1,1) = {"
M
M
M
M
P
U
v
O
W
T
q
"}
(13,1,1) = {"
M
M
M
M
P
a
h
H
s
a
a
"}
(14,1,1) = {"
M
M
M
M
P
a
h
H
s
a
a
"}
(15,1,1) = {"
M
M
M
M
P
a
h
H
s
a
a
"}
(16,1,1) = {"
M
M
M
M
P
a
h
H
s
a
a
"}
(17,1,1) = {"
M
M
M
M
P
a
h
H
s
a
a
"}
(18,1,1) = {"
M
M
M
M
P
a
h
H
s
a
a
"}
(19,1,1) = {"
M
M
M
M
P
a
h
H
s
a
a
"}
(20,1,1) = {"
M
M
M
M
P
a
h
H
s
a
a
"}
(21,1,1) = {"
M
M
M
M
P
a
h
H
s
a
a
"}
(22,1,1) = {"
M
M
M
M
P
a
h
H
s
a
a
"}
(23,1,1) = {"
M
M
M
M
P
a
h
H
s
a
a
"}
(24,1,1) = {"
M
M
M
M
P
a
h
H
s
a
a
"}
(25,1,1) = {"
M
M
M
M
P
a
h
H
s
a
a
"}
(26,1,1) = {"
M
M
M
M
P
a
h
H
s
a
a
"}
(27,1,1) = {"
M
M
M
M
P
a
h
H
s
a
a
"}
(28,1,1) = {"
M
M
M
M
P
a
h
H
s
a
a
"}
