//MAP CONVERTED BY dmm2tgm.py THIS HEADER COMMENT PREVENTS RECONVERSION, DO NOT REMOVE
"aI" = (
/obj/effect/turf_decal/trimline/green/filled/line,
/obj/machinery/light/directional/south,
/obj/structure/railing/corner{
	dir = 8
	},
/obj/machinery/status_display/shuttle/directional/south,
/turf/open/floor/iron/white,
/area/station/hallway/secondary/entry)
"ge" = (
/obj/effect/turf_decal/trimline/green/filled/line{
	dir = 4
	},
/obj/machinery/atmospherics/components/unary/vent_pump/on/layer4{
	dir = 8
	},
/obj/machinery/status_display/shuttle/directional/east,
/turf/open/floor/iron/white,
/area/station/hallway/secondary/entry)
"gV" = (
/obj/effect/turf_decal/trimline/green/filled/line,
/obj/machinery/light/directional/south,
/obj/structure/railing/corner,
/obj/machinery/status_display/shuttle/directional/south,
/turf/open/floor/iron/white,
/area/station/hallway/secondary/entry)
"iB" = (
/obj/docking_port/stationary{
	dir = 2;
	dwidth = 1;
	height = 13;
	shuttle_id = "arrivals_stationary";
	name = "arrivals";
	width = 5
	},
/turf/open/floor/engine,
/area/station/hallway/secondary/entry)
"zU" = (
/obj/effect/turf_decal/trimline/green/filled/line,
/obj/machinery/status_display/evac/directional/south,
/turf/open/floor/iron/white,
/area/station/hallway/secondary/entry)
"MQ" = (
/turf/open/floor/engine,
/area/station/hallway/secondary/entry)
"Tp" = (
/obj/effect/turf_decal/trimline/green/filled/line{
	dir = 8
	},
/obj/machinery/atmospherics/components/unary/vent_scrubber/on/layer2{
	dir = 4
	},
/obj/machinery/status_display/shuttle/directional/west,
/turf/open/floor/iron/white,
/area/station/hallway/secondary/entry)
"Vc" = (
/obj/effect/turf_decal/trimline/green/filled/line{
	dir = 8
	},
/obj/machinery/atmospherics/components/unary/vent_pump/on/layer4{
	dir = 4
	},
/obj/machinery/status_display/shuttle/directional/west,
/turf/open/floor/iron/white,
/area/station/hallway/secondary/entry)
"Vt" = (
/turf/template_noop,
/area/template_noop)
"Yk" = (
/obj/machinery/computer/shuttle/arrivals/recall{
	dir = 4
	},
/turf/template_noop,
/area/template_noop)

(1,1,1) = {"
Vt
Vt
Vt
Vt
Tp
Vt
Vt
Vt
Vt
Vt
Vt
Vt
Vt
Vt
Vt
Vt
Vc
Vt
Vt
Vt
Vt
"}
(2,1,1) = {"
Vt
Vt
Vt
Vt
Vt
Vt
Vt
Vt
Vt
Vt
Vt
Vt
Vt
Vt
Vt
Vt
Vt
Vt
Vt
Vt
gV
"}
(3,1,1) = {"
Vt
Vt
Vt
Vt
Vt
Vt
Vt
Vt
Vt
Vt
Vt
Vt
Vt
Vt
Vt
Vt
Vt
Vt
Vt
Vt
Vt
"}
(4,1,1) = {"
Vt
Vt
Vt
Vt
Vt
Vt
Vt
Vt
Vt
Vt
Vt
Vt
Vt
Vt
Vt
Vt
Vt
Vt
Vt
Vt
Vt
"}
(5,1,1) = {"
Vt
Vt
Vt
Vt
Vt
Vt
Vt
Vt
Vt
Vt
Vt
Vt
Vt
Vt
Vt
Vt
Vt
Vt
Vt
Vt
Vt
"}
(6,1,1) = {"
Vt
Vt
Vt
Vt
Vt
Vt
Vt
Vt
Vt
Vt
Vt
Vt
Vt
Vt
Vt
Vt
Vt
Vt
Vt
Vt
Vt
"}
(7,1,1) = {"
Vt
Vt
Vt
Vt
Vt
Vt
Vt
Vt
Vt
Vt
Vt
Vt
Vt
Vt
Vt
Vt
Vt
MQ
Vt
Vt
zU
"}
(8,1,1) = {"
Vt
Vt
Vt
Vt
iB
Vt
Vt
Vt
Vt
Vt
Vt
Vt
Vt
Vt
Vt
Vt
Vt
Vt
Vt
Vt
Vt
"}
(9,1,1) = {"
Vt
Vt
Vt
Vt
Vt
Vt
Vt
Vt
Vt
Vt
Vt
Vt
Vt
Vt
Vt
Vt
Vt
Vt
Vt
Vt
Vt
"}
(10,1,1) = {"
Vt
Vt
Vt
Vt
Vt
Vt
Vt
Vt
Vt
Vt
Vt
Vt
Vt
Vt
Vt
Vt
Vt
Vt
Vt
Vt
Vt
"}
(11,1,1) = {"
Vt
Vt
Vt
Vt
Vt
Vt
Vt
Vt
Vt
Vt
Vt
Vt
Vt
Vt
Vt
Vt
Vt
Vt
Vt
Vt
Vt
"}
(12,1,1) = {"
Vt
Vt
Vt
Yk
Vt
Vt
Vt
Vt
Vt
Vt
Vt
Vt
Vt
Vt
Vt
Vt
Vt
Vt
Vt
Vt
aI
"}
(13,1,1) = {"
Vt
Vt
Vt
Vt
ge
Vt
Vt
Vt
Vt
Vt
Vt
Vt
Vt
Vt
Vt
Vt
Vt
Vt
Vt
Vt
Vt
"}
