//MAP CONVERTED BY dmm2tgm.py THIS HEADER COMMENT PREVENTS RECONVERSION, DO NOT REMOVE
"cs" = (
/obj/effect/turf_decal/siding/wood,
/obj/structure/table/wood,
/obj/item/food/egg/raptor_egg,
/obj/item/food/egg/raptor_egg,
/turf/open/floor/stone,
/area/ruin/powered/hermit)
"ea" = (
/obj/effect/turf_decal/siding/wood{
	dir = 1
	},
/obj/effect/turf_decal/siding/wood/corner{
	dir = 8
	},
/turf/open/floor/stone,
/area/ruin/powered/hermit)
"ee" = (
/obj/effect/mob_spawn/ghost_role/human/hermit,
/turf/open/floor/wood/large,
/area/ruin/powered/hermit)
"en" = (
/obj/structure/chair/sofa/corner{
	dir = 4
	},
/turf/open/floor/carpet/royalblack,
/area/ruin/powered/hermit)
"fy" = (
/obj/structure/railing/wooden_fencing{
	dir = 1
	},
/turf/open/misc/asteroid/basalt/lava_land_surface,
/area/ruin/powered/hermit)
"gu" = (
/obj/structure/railing/wooden_fencing{
	dir = 1
	},
/obj/structure/railing/wooden_fencing{
	dir = 8
	},
/turf/open/misc/asteroid/basalt/lava_land_surface,
/area/ruin/powered/hermit)
"gT" = (
/obj/effect/turf_decal/siding/wood{
	dir = 1
	},
/turf/open/floor/stone,
/area/ruin/powered/hermit)
"gX" = (
/obj/item/storage/bag/plants/portaseeder,
/obj/item/cultivator,
/obj/structure/decorative/shelf,
/turf/open/misc/asteroid/basalt/lava_land_surface,
/area/ruin/powered/hermit)
"hH" = (
/obj/machinery/smartfridge/wooden/produce_bin,
/obj/structure/railing/wooden_fencing{
	dir = 3
	},
/turf/open/misc/asteroid/basalt/lava_land_surface,
/area/ruin/powered/hermit)
"iJ" = (
/obj/machinery/space_heater,
/turf/open/floor/wood/large,
/area/ruin/powered/hermit)
"jG" = (
/obj/item/storage/medkit/regular,
/obj/structure/decorative/shelf,
/obj/item/storage/medkit/surgery,
/obj/item/clothing/neck/stethoscope,
/turf/open/floor/wood/large,
/area/ruin/powered/hermit)
"lm" = (
/obj/item/clothing/head/helmet/space/orange,
/obj/item/clothing/suit/space/orange,
/obj/structure/decorative/shelf,
/turf/open/floor/wood/large,
/area/ruin/powered/hermit)
"lC" = (
/obj/effect/turf_decal/siding/wood{
	dir = 5
	},
/turf/open/floor/stone,
/area/ruin/powered/hermit)
"mN" = (
/obj/structure/fireplace{
	pixel_y = -2;
	dir = 8
	},
/turf/open/floor/wood/large,
/area/ruin/powered/hermit)
"mV" = (
/obj/structure/decorative/shelf,
/obj/item/raptor_dex,
/turf/open/floor/wood/large,
/area/ruin/powered/hermit)
"ow" = (
/obj/structure/chair/sofa/right{
	dir = 4
	},
/obj/effect/turf_decal/siding/wood,
/turf/open/floor/carpet/royalblack,
/area/ruin/powered/hermit)
"oW" = (
/obj/structure/water_source/puddle,
/turf/open/misc/asteroid/basalt/lava_land_surface,
/area/lavaland/surface/outdoors)
"oX" = (
/obj/effect/turf_decal/siding/wood{
	dir = 4
	},
/obj/structure/chair/sofa/left,
/turf/open/floor/carpet/royalblack,
/area/ruin/powered/hermit)
"pM" = (
/obj/structure/railing/wooden_fencing{
	dir = 3
	},
/obj/structure/railing/wooden_fencing{
	dir = 8
	},
/turf/open/misc/asteroid/basalt/lava_land_surface,
/area/ruin/powered/hermit)
"qr" = (
/obj/item/xenoarch/handheld_recoverer,
/obj/structure/closet/crate/grave/filled,
/obj/effect/decal/remains/human,
/obj/item/pickaxe/silver,
/obj/item/stock_parts/matter_bin,
/obj/item/stock_parts/matter_bin,
/obj/item/stock_parts/matter_bin,
/obj/item/stock_parts/servo,
/obj/item/stack/cable_coil/five,
/turf/open/misc/asteroid/basalt/lava_land_surface,
/area/lavaland/surface/outdoors)
"re" = (
/obj/structure/table/wood/fancy/black,
/obj/effect/turf_decal/siding/wood{
	dir = 6
	},
/turf/open/floor/carpet/royalblack,
/area/ruin/powered/hermit)
"rT" = (
/obj/machinery/portable_atmospherics/canister/oxygen,
/turf/open/floor/wood/large,
/area/ruin/powered/hermit)
"rV" = (
/turf/closed/mineral/volcanic/lava_land_surface,
/area/lavaland/surface/outdoors)
"tn" = (
/mob/living/basic/raptor/baby_raptor/red,
/turf/open/misc/asteroid/basalt/lava_land_surface,
/area/lavaland/surface/outdoors)
"tA" = (
/obj/effect/turf_decal/siding/wood{
	dir = 4
	},
/obj/effect/turf_decal/siding/wood{
	dir = 8
	},
/obj/structure/curtain/bounty,
/turf/open/floor/stone,
/area/ruin/powered/hermit)
"tJ" = (
/turf/open/floor/wood/large,
/area/ruin/powered/hermit)
"vi" = (
/obj/effect/turf_decal/siding/wood,
/turf/open/floor/stone,
/area/ruin/powered/hermit)
"vt" = (
/obj/structure/ore_box,
/obj/structure/railing/wooden_fencing{
	dir = 1
	},
/turf/open/misc/asteroid/basalt/lava_land_surface,
/area/ruin/powered/hermit)
"wv" = (
/turf/template_noop,
/area/template_noop)
"xi" = (
/obj/item/shovel,
/obj/structure/wormfarm,
/turf/open/misc/asteroid/basalt/lava_land_surface,
/area/ruin/powered/hermit)
"xR" = (
/obj/effect/turf_decal/siding/wood{
	dir = 8
	},
/turf/open/floor/stone,
/area/ruin/powered/hermit)
"yR" = (
/obj/structure/table/wood/fancy/black,
/obj/effect/turf_decal/siding/wood,
/obj/item/kitchen/fork,
/obj/item/plate,
/obj/item/food/meat/steak/goliath,
/turf/open/floor/carpet/royalblack,
/area/ruin/powered/hermit)
"zk" = (
/obj/item/pickaxe/emergency,
/obj/structure/decorative/shelf,
/obj/item/storage/bag/ore,
/obj/item/mining_scanner,
/turf/open/misc/asteroid/basalt/lava_land_surface,
/area/ruin/powered/hermit)
"zZ" = (
/obj/effect/turf_decal/siding/wood{
	dir = 10
	},
/turf/open/floor/stone,
/area/ruin/powered/hermit)
"Ao" = (
/obj/structure/glowshroom/single,
/obj/structure/closet/crate/wooden/storage_barrel,
/turf/open/floor/wood/large,
/area/ruin/powered/hermit)
"AF" = (
/obj/effect/turf_decal/siding/wood/corner,
/obj/effect/turf_decal/siding/wood/corner{
	dir = 8
	},
/turf/open/floor/stone,
/area/ruin/powered/hermit)
"BC" = (
/obj/structure/mineral_door/wood/large_gate{
	dir = 4
	},
/obj/structure/fans/tiny,
/obj/effect/turf_decal/siding/wood/end{
	dir = 8
	},
/turf/open/floor/stone,
/area/ruin/powered/hermit)
"BS" = (
/obj/structure/chair/sofa/middle,
/turf/open/floor/carpet/royalblack,
/area/ruin/powered/hermit)
"CR" = (
/turf/open/misc/asteroid/basalt/lava_land_surface,
/area/lavaland/surface/outdoors)
"Dh" = (
/obj/structure/decorative/shelf,
/obj/item/flashlight/lantern,
/obj/item/xenoarch/tape_measure,
/obj/item/xenoarch/brush,
/turf/open/floor/wood/large,
/area/ruin/powered/hermit)
"Gs" = (
/obj/effect/turf_decal/siding/wood{
	dir = 6
	},
/turf/open/floor/stone,
/area/ruin/powered/hermit)
"Jg" = (
/obj/structure/table/wood,
/obj/item/flashlight/flare/torch,
/obj/item/flashlight/flare/torch,
/turf/open/floor/wood/large,
/area/ruin/powered/hermit)
"NR" = (
/obj/structure/curtain/bounty,
/turf/open/floor/wood/large,
/area/ruin/powered/hermit)
"Pa" = (
/obj/structure/reagent_water_basin,
/turf/open/misc/asteroid/basalt/lava_land_surface,
/area/ruin/powered/hermit)
"PT" = (
/obj/structure/safe/floor,
/obj/item/flatpacked_machine/wind_turbine,
/obj/item/flatpacked_machine/wind_turbine,
/obj/item/pipe_dispenser,
/obj/item/circuitboard/machine/autolathe,
/turf/open/floor/wood/large,
/area/ruin/powered/hermit)
"Rd" = (
/obj/item/tank/internals/oxygen,
/obj/item/tank/internals/oxygen,
/obj/structure/decorative/shelf,
/obj/item/flashlight/flare/torch,
/obj/item/flashlight/flare/torch,
/turf/open/floor/wood/large,
/area/ruin/powered/hermit)
"Rf" = (
/obj/effect/turf_decal/siding/wood{
	dir = 10
	},
/obj/structure/table/wood,
/obj/structure/closet/crate/wooden,
/obj/item/flashlight/flare/torch,
/obj/item/flashlight/flare/torch,
/obj/item/flashlight/flare/torch,
/obj/item/flashlight/flare/torch,
/turf/open/floor/stone,
/area/ruin/powered/hermit)
"SO" = (
/obj/structure/ore_container/food_trough/raptor_trough,
/turf/open/misc/asteroid/basalt/lava_land_surface,
/area/lavaland/surface/outdoors)
"Tx" = (
/obj/effect/turf_decal/siding/wood{
	dir = 1
	},
/obj/structure/sink/directional/south,
/turf/open/floor/stone,
/area/ruin/powered/hermit)
"TS" = (
/obj/machinery/smartfridge/wooden/seed_shelf,
/obj/item/seeds/tower,
/obj/item/food/grown/mushroom/glowshroom,
/obj/item/seeds/plump,
/obj/item/seeds/reishi,
/turf/open/misc/asteroid/basalt/lava_land_surface,
/area/ruin/powered/hermit)
"Uo" = (
/turf/closed/wall/mineral/stone,
/area/ruin/powered/hermit)
"UY" = (
/obj/item/storage/toolbox/mechanical,
/obj/structure/decorative/shelf,
/turf/open/floor/wood/large,
/area/ruin/powered/hermit)
"XG" = (
/obj/effect/turf_decal/siding/wood{
	dir = 4
	},
/turf/open/floor/stone,
/area/ruin/powered/hermit)
"Zj" = (
/turf/open/misc/asteroid/basalt/lava_land_surface,
/area/ruin/powered/hermit)
"Zt" = (
/obj/structure/railing/wooden_fencing/gate,
/turf/open/misc/asteroid/basalt/lava_land_surface,
/area/ruin/powered/hermit)
"Zu" = (
/obj/effect/turf_decal/siding/wood/corner{
	dir = 8
	},
/obj/effect/turf_decal/siding/wood/corner,
/turf/open/floor/stone,
/area/ruin/powered/hermit)

(1,1,1) = {"
wv
wv
rV
rV
rV
rV
rV
rV
rV
rV
rV
rV
rV
rV
rV
wv
"}
(2,1,1) = {"
wv
wv
rV
gu
Zj
Zj
Zj
Zj
Zj
Zj
Zj
Zj
pM
qr
rV
rV
"}
(3,1,1) = {"
wv
rV
rV
fy
Zj
Zj
Zj
Zj
Zj
Zj
Zj
Zj
Zt
CR
CR
rV
"}
(4,1,1) = {"
rV
rV
rV
vt
zk
Zj
Zj
Zj
Pa
gX
TS
xi
hH
CR
CR
rV
"}
(5,1,1) = {"
rV
Uo
Uo
Uo
Uo
Uo
BC
Uo
Uo
Uo
Uo
Uo
Uo
tn
CR
rV
"}
(6,1,1) = {"
rV
Uo
en
ow
tJ
Uo
ea
Rf
Uo
ee
ee
Ao
Uo
SO
CR
rV
"}
(7,1,1) = {"
rV
Uo
BS
yR
tJ
Uo
gT
cs
Uo
tJ
tJ
Dh
Uo
CR
CR
rV
"}
(8,1,1) = {"
rV
Uo
oX
re
tJ
Uo
gT
Zu
tA
xR
zZ
mV
Uo
CR
CR
rV
"}
(9,1,1) = {"
rV
Uo
tJ
mN
tJ
NR
gT
vi
Uo
Uo
Uo
Uo
Uo
oW
CR
rV
"}
(10,1,1) = {"
rV
Uo
Uo
Uo
Uo
Uo
Tx
AF
tA
XG
Gs
Rd
Uo
CR
rV
rV
"}
(11,1,1) = {"
rV
Uo
Jg
jG
Uo
lm
gT
vi
Uo
UY
tJ
iJ
Uo
rV
rV
rV
"}
(12,1,1) = {"
rV
Uo
tJ
tJ
tJ
NR
lC
Gs
Uo
PT
tJ
rT
Uo
rV
rV
rV
"}
(13,1,1) = {"
rV
Uo
Uo
Uo
Uo
Uo
Uo
Uo
Uo
Uo
Uo
Uo
Uo
rV
rV
rV
"}
(14,1,1) = {"
rV
rV
rV
rV
rV
rV
rV
rV
rV
rV
rV
rV
rV
rV
rV
wv
"}
(15,1,1) = {"
wv
wv
rV
rV
wv
wv
wv
wv
wv
wv
wv
wv
wv
wv
wv
wv
"}
(16,1,1) = {"
wv
wv
wv
wv
wv
wv
wv
wv
wv
wv
wv
wv
wv
wv
wv
wv
"}
