//MAP CONVERTED BY dmm2tgm.py THIS HEADER COMMENT PREVENTS RECONVERSION, DO NOT REMOVE
"aJ" = (
/obj/item/reagent_containers/cup/glass/bottle/wine/unlabeled{
	pixel_x = 5;
	pixel_y = 7
	},
/obj/structure/table/wood,
/obj/item/reagent_containers/cup/glass/trophy{
	pixel_y = 18;
	pixel_x = -4
	},
/obj/item/reagent_containers/cup/glass/trophy{
	pixel_y = 10;
	pixel_x = -8
	},
/obj/item/flashlight/flare/candle/infinite{
	pixel_y = 6
	},
/turf/open/floor/stone,
/area/misc/condo)
"cr" = (
/obj/structure/railing/wooden_fencing{
	dir = 4
	},
/obj/effect/turf_decal/siding/wood{
	dir = 4
	},
/turf/open/misc/snow,
/area/misc/condo)
"cy" = (
/obj/machinery/door/airlock/wood,
/obj/structure/fans/tiny/invisible,
/turf/open/floor/wood/large,
/area/misc/condo)
"dt" = (
/obj/structure/railing,
/obj/effect/turf_decal/siding/wood{
	dir = 3
	},
/turf/open/floor/stone,
/area/misc/condo)
"dL" = (
/turf/open/misc/asteroid/snow/indestructible/planet,
/area/misc/condo)
"ee" = (
/obj/machinery/light/dim{
	dir = 4
	},
/obj/structure/dresser,
/obj/effect/turf_decal/siding/wood{
	dir = 3
	},
/turf/open/floor/carpet/red,
/area/misc/condo)
"et" = (
/obj/structure/fake_stairs/wood/directional/east,
/obj/machinery/door/airlock/wood,
/turf/open/floor/iron/dark/brick,
/area/misc/condo)
"fd" = (
/obj/structure/chair/sofa/corp/left{
	dir = 8
	},
/turf/open/floor/wood/wood_5,
/area/misc/condo)
"fB" = (
/obj/structure/window/green_glass_pane,
/obj/structure/curtain/bounty,
/turf/open/floor/iron/dark/brick,
/area/misc/condo)
"fO" = (
/obj/structure/marker_beacon/burgundy,
/turf/open/misc/snow,
/area/misc/condo)
"gn" = (
/obj/machinery/door/airlock/wood,
/obj/effect/turf_decal/siding/wood{
	dir = 4
	},
/obj/effect/turf_decal/siding/wood{
	dir = 8
	},
/turf/open/floor/iron/dark/brick,
/area/misc/condo)
"gq" = (
/obj/structure/decorative/shelf,
/obj/item/grown/log/tree,
/obj/item/grown/log/tree,
/obj/item/grown/log/tree,
/obj/item/storage/box/matches,
/obj/item/hatchet/wooden,
/obj/effect/turf_decal/siding/wood{
	dir = 9
	},
/turf/open/floor/wood/large,
/area/misc/condo)
"is" = (
/turf/closed/indestructible/wood,
/area/misc/condo)
"iy" = (
/turf/open/floor/iron/dark/brick,
/area/misc/condo)
"iB" = (
/obj/structure/railing{
	dir = 8
	},
/obj/effect/turf_decal/siding/wood{
	dir = 8
	},
/turf/open/floor/stone,
/area/misc/condo)
"iD" = (
/obj/structure/window/green_glass_pane,
/obj/structure/curtain/cloth/fancy/mechanical/start_closed{
	icon_state = "bounty-closed";
	icon_type = "bounty"
	},
/turf/open/floor/iron/dark/brick,
/area/misc/condo)
"jj" = (
/obj/effect/turf_decal/siding/wood{
	dir = 4
	},
/obj/machinery/light/dim,
/turf/open/floor/wood/large,
/area/misc/condo)
"kn" = (
/obj/structure/bookcase/random/adult,
/turf/open/floor/wood/large,
/area/misc/condo)
"kN" = (
/obj/effect/turf_decal/siding/wood{
	dir = 8
	},
/turf/open/misc/snow,
/area/misc/condo)
"mp" = (
/obj/effect/turf_decal/siding/wood{
	dir = 3
	},
/obj/machinery/light/dim{
	dir = 4
	},
/turf/open/floor/wood/wood_5,
/area/misc/condo)
"nJ" = (
/obj/item/towel,
/obj/item/towel,
/obj/item/towel,
/obj/structure/rack/wooden,
/turf/open/floor/stone,
/area/misc/condo)
"nL" = (
/obj/structure/railing/wooden_fencing,
/obj/effect/turf_decal/siding/wood{
	dir = 3
	},
/turf/open/floor/wood/large,
/area/misc/condo)
"oo" = (
/obj/structure/chair/sofa/corp/right,
/turf/open/floor/wood/wood_5,
/area/misc/condo)
"sj" = (
/obj/effect/turf_decal/siding/wood{
	dir = 6
	},
/obj/item/gun/ballistic/shotgun/doublebarrel{
	pixel_x = -16;
	pixel_y = 33
	},
/turf/open/floor/stone,
/area/misc/condo)
"sI" = (
/obj/structure/flora/grass/green/style_random,
/turf/open/misc/snow,
/area/misc/condo)
"tc" = (
/obj/machinery/light/dim,
/turf/open/floor/wood/large,
/area/misc/condo)
"th" = (
/obj/structure/chair/sofa/corp/corner,
/turf/open/floor/wood/wood_5,
/area/misc/condo)
"tW" = (
/obj/structure/decorative/shelf,
/obj/item/flashlight/lantern,
/obj/item/flashlight/lantern,
/turf/open/floor/wood/large,
/area/misc/condo)
"uq" = (
/turf/open/floor/wood/wood_5,
/area/misc/condo)
"uC" = (
/obj/effect/turf_decal/siding/wood{
	dir = 1
	},
/obj/structure/window/green_glass_pane,
/obj/structure/curtain/bounty,
/turf/open/floor/stone,
/area/misc/condo)
"uG" = (
/turf/open/floor/stone,
/area/misc/condo)
"vx" = (
/obj/structure/railing/wooden_fencing{
	dir = 8
	},
/obj/effect/turf_decal/siding/wood{
	dir = 8
	},
/turf/open/misc/snow,
/area/misc/condo)
"vF" = (
/obj/machinery/light/floor,
/turf/open/water/hot_spring/cafe,
/area/misc/condo)
"wB" = (
/turf/open/water/hot_spring/cafe,
/area/misc/condo)
"wV" = (
/turf/open/floor/wood/large,
/area/misc/condo)
"xt" = (
/turf/closed/wall/ice,
/area/misc/condo)
"xC" = (
/obj/effect/turf_decal/siding/wood{
	dir = 3
	},
/turf/open/floor/wood/wood_5,
/area/misc/condo)
"yi" = (
/obj/structure/sign/painting/library,
/turf/closed/indestructible/wood,
/area/misc/condo)
"Ai" = (
/obj/structure/closet/secure_closet/personal/cabinet,
/turf/open/floor/wood/large,
/area/misc/condo)
"CX" = (
/obj/effect/turf_decal/siding/wood{
	dir = 10
	},
/turf/open/floor/carpet/red,
/area/misc/condo)
"EE" = (
/obj/structure/chair/wood{
	dir = 4
	},
/turf/open/floor/stone,
/area/misc/condo)
"FN" = (
/obj/structure/decorative/shelf,
/obj/item/storage/fancy/candle_box,
/obj/item/storage/fancy/candle_box,
/obj/item/lighter,
/turf/open/floor/iron/dark/brick,
/area/misc/condo)
"Gg" = (
/obj/machinery/light/small/red/directional/north,
/turf/open/floor/wood/large,
/area/misc/condo)
"Gv" = (
/obj/machinery/door/airlock/wood,
/turf/open/floor/wood/large,
/area/misc/condo)
"Hp" = (
/obj/structure/flora/tree/pine/style_random,
/turf/open/misc/snow,
/area/misc/condo)
"HX" = (
/obj/structure/decorative/shelf,
/obj/item/storage/box/slugs,
/obj/item/storage/box/slugs,
/turf/open/floor/iron/dark/brick,
/area/misc/condo)
"Iz" = (
/obj/effect/turf_decal/siding/wood{
	dir = 1
	},
/obj/structure/railing/wooden_fencing/gate,
/turf/open/floor/stone,
/area/misc/condo)
"IL" = (
/obj/effect/turf_decal/siding/wood{
	dir = 8
	},
/turf/open/floor/carpet/red,
/area/misc/condo)
"IO" = (
/obj/structure/decorative/shelf/crates1,
/turf/open/floor/iron/dark/brick,
/area/misc/condo)
"IS" = (
/obj/machinery/light/dim,
/turf/open/floor/iron/dark/brick,
/area/misc/condo)
"Lx" = (
/obj/effect/turf_decal/siding/wood{
	dir = 4
	},
/turf/open/misc/snow,
/area/misc/condo)
"LY" = (
/obj/structure/window/green_glass_pane,
/obj/structure/curtain/bounty,
/turf/closed/indestructible/wood,
/area/misc/condo)
"Pa" = (
/obj/machinery/light/dim,
/obj/machinery/light_switch/directional/south,
/turf/open/floor/wood/large,
/area/misc/condo)
"Pd" = (
/obj/item/clothing/suit/hooded/wintercoat,
/obj/item/clothing/suit/hooded/wintercoat,
/obj/structure/closet/secure_closet/personal/cabinet,
/turf/open/floor/wood/large,
/area/misc/condo)
"Pw" = (
/turf/open/floor/wood/wood_11,
/area/misc/condo)
"Qx" = (
/turf/open/misc/snow,
/area/misc/condo)
"Rk" = (
/obj/structure/fake_stairs/wood,
/turf/open/misc/snow,
/area/misc/condo)
"Rs" = (
/obj/structure/fireplace/nova{
	pixel_x = 0
	},
/obj/effect/turf_decal/siding/wood{
	dir = 10
	},
/turf/open/floor/stone,
/area/misc/condo)
"RL" = (
/obj/machinery/light_switch/directional/south,
/turf/open/floor/wood/wood_11,
/area/misc/condo)
"Tc" = (
/turf/closed/indestructible/hoteldoor/fakedoor,
/area/misc/condo)
"Tv" = (
/obj/structure/chair/wood,
/turf/open/floor/stone,
/area/misc/condo)
"Uq" = (
/obj/structure/decorative/shelf,
/obj/item/storage/box/papersack/ration_bread_slice,
/obj/item/storage/box/colonial_rations,
/obj/item/storage/box/colonial_rations,
/obj/item/storage/box/colonial_rations,
/turf/open/floor/iron/dark/brick,
/area/misc/condo)
"UP" = (
/obj/structure/decorative/shelf,
/obj/item/mop,
/obj/item/reagent_containers/cup/bucket/wooden,
/obj/item/reagent_containers/spray/cleaner,
/turf/open/floor/iron/dark/brick,
/area/misc/condo)
"UQ" = (
/obj/machinery/shower/directional/east,
/obj/structure/decorative{
	icon_state = "drain";
	icon = 'modular_nova/modules/liquids/icons/obj/structures/drains.dmi';
	base_icon_state = "drain";
	dir = 8;
	pixel_y = 3;
	pixel_x = -2
	},
/obj/effect/turf_decal/siding/wideplating_new/dark{
	dir = 6
	},
/turf/open/floor/stone,
/area/misc/condo)
"Vs" = (
/obj/structure/bed/double,
/obj/item/bedsheet/black/double,
/turf/open/floor/carpet/red,
/area/misc/condo)
"VI" = (
/obj/effect/turf_decal/siding/wood{
	dir = 4
	},
/turf/open/floor/wood/large,
/area/misc/condo)
"Xm" = (
/turf/closed/wall/mineral/stone,
/area/misc/condo)
"Xu" = (
/obj/structure/table/wood,
/obj/item/flashlight/lamp/green,
/turf/open/floor/wood/wood_5,
/area/misc/condo)
"XS" = (
/obj/structure/flora/rock/pile/icy/style_random,
/turf/open/misc/snow,
/area/misc/condo)
"YS" = (
/obj/item/clothing/head/drake_skull{
	anchored = 1
	},
/turf/closed/indestructible/wood,
/area/misc/condo)

(1,1,1) = {"
xt
xt
xt
xt
xt
xt
xt
xt
xt
xt
xt
xt
xt
xt
xt
xt
xt
xt
xt
xt
xt
xt
xt
xt
xt
xt
xt
xt
xt
xt
xt
xt
xt
xt
xt
xt
"}
(2,1,1) = {"
xt
xt
xt
xt
xt
xt
xt
Qx
Qx
Qx
Qx
Qx
Qx
xt
xt
xt
xt
xt
Qx
Qx
Qx
Qx
Qx
Qx
Qx
Qx
Qx
Qx
Qx
Qx
Qx
xt
xt
xt
xt
xt
"}
(3,1,1) = {"
xt
xt
xt
xt
Qx
Qx
Qx
Qx
Qx
Qx
Qx
Qx
Qx
Qx
Qx
Qx
Qx
Qx
Qx
Qx
Qx
Qx
Qx
Qx
Qx
Qx
XS
Qx
Qx
Qx
Qx
Qx
Qx
Qx
xt
xt
"}
(4,1,1) = {"
xt
xt
xt
dL
Qx
Qx
Qx
Qx
Qx
Qx
Qx
sI
Qx
Qx
Qx
Qx
Qx
Qx
Qx
Qx
sI
Qx
Qx
Qx
Qx
Qx
Qx
Qx
Qx
Qx
Qx
Qx
Qx
Qx
Qx
xt
"}
(5,1,1) = {"
xt
xt
xt
dL
sI
Qx
Qx
Qx
sI
Qx
Hp
sI
Qx
Qx
Qx
Qx
Qx
Qx
Qx
Qx
Qx
Qx
Qx
Qx
Qx
Qx
Qx
Qx
Qx
Qx
Qx
sI
Qx
Qx
Qx
xt
"}
(6,1,1) = {"
xt
xt
dL
dL
Qx
Qx
Qx
Qx
Qx
Qx
Qx
Qx
Qx
Qx
Qx
Qx
Qx
Qx
Qx
Qx
Qx
Qx
Qx
Qx
Qx
Qx
Qx
Qx
Qx
Qx
Qx
Qx
Qx
Qx
Qx
xt
"}
(7,1,1) = {"
xt
xt
dL
dL
Qx
Qx
Qx
Qx
Qx
Qx
Qx
Qx
Qx
Qx
Qx
Qx
Qx
Qx
Qx
Qx
Qx
Qx
Qx
Qx
Qx
Qx
Hp
Qx
Qx
Qx
Qx
Qx
Qx
Qx
xt
xt
"}
(8,1,1) = {"
xt
xt
dL
dL
Qx
XS
Qx
Qx
Qx
Qx
Qx
Qx
Qx
Qx
Qx
XS
Qx
Hp
Qx
Qx
Qx
Qx
Qx
Qx
Qx
Qx
Qx
Qx
Qx
Qx
Qx
Qx
Qx
XS
xt
xt
"}
(9,1,1) = {"
xt
xt
dL
Qx
Qx
Qx
Qx
Qx
Qx
Qx
Qx
Qx
Qx
Qx
Qx
Qx
Qx
Qx
Qx
Qx
Qx
Qx
Qx
Qx
Qx
Qx
Qx
Qx
sI
Qx
Qx
Qx
Qx
Qx
Qx
xt
"}
(10,1,1) = {"
xt
xt
dL
Qx
Qx
Qx
Qx
sI
Qx
Qx
Qx
Qx
Qx
sI
Qx
Qx
Qx
Qx
Qx
Qx
Qx
sI
Qx
Qx
Qx
Qx
Qx
Qx
Qx
Qx
Qx
Qx
Qx
Qx
Qx
xt
"}
(11,1,1) = {"
xt
xt
dL
Qx
Qx
Qx
Qx
Qx
Qx
Qx
Qx
Qx
Qx
Qx
Qx
Qx
Qx
Qx
Qx
Qx
Qx
Qx
Qx
Qx
Qx
Qx
Hp
Qx
Qx
Qx
Qx
Qx
Qx
Qx
Qx
xt
"}
(12,1,1) = {"
xt
xt
dL
Qx
Hp
Qx
Qx
Qx
Qx
Qx
Qx
Qx
Qx
Qx
Qx
Qx
is
iD
iD
iD
is
iD
iD
iD
is
Qx
Qx
Qx
Qx
Qx
Qx
Qx
Qx
Qx
Qx
xt
"}
(13,1,1) = {"
xt
xt
dL
Qx
Qx
Qx
Qx
Qx
Qx
Qx
Qx
Qx
Qx
Qx
Qx
Qx
iD
Pw
Pw
Pw
is
FN
Uq
UP
is
Qx
Qx
Qx
Qx
Qx
XS
Qx
Qx
Qx
Qx
xt
"}
(14,1,1) = {"
xt
xt
dL
Qx
Qx
Qx
Qx
Qx
Qx
Qx
Qx
Hp
Qx
Qx
Qx
Qx
iD
IL
CX
Pw
is
iy
iy
IS
is
Qx
Qx
Qx
Qx
Qx
Qx
Qx
Qx
Qx
Qx
xt
"}
(15,1,1) = {"
xt
xt
dL
Qx
Qx
Qx
Qx
Qx
Qx
Qx
Qx
Qx
Qx
Qx
Qx
Qx
iD
Vs
ee
RL
is
iy
IO
HX
is
Qx
sI
Qx
Qx
Qx
Qx
Qx
Qx
Hp
Qx
xt
"}
(16,1,1) = {"
xt
Qx
Qx
Qx
Qx
Qx
Qx
Qx
Qx
Qx
Qx
Qx
Qx
Qx
Qx
Qx
is
is
is
gn
is
et
is
is
is
cr
Qx
Qx
Qx
Qx
Qx
Qx
Qx
Qx
Qx
xt
"}
(17,1,1) = {"
xt
Qx
Qx
Qx
Qx
Qx
Qx
Qx
Qx
Qx
Qx
Qx
Qx
sI
Qx
Qx
YS
gq
wV
wV
wV
wV
Pd
is
tW
nL
Qx
Qx
Qx
fO
Qx
Qx
Qx
Qx
Qx
xt
"}
(18,1,1) = {"
xt
Qx
Qx
Qx
Qx
Qx
Qx
Qx
Qx
Qx
Qx
Qx
Qx
Qx
Qx
Qx
Xm
Rs
wV
wV
wV
wV
Pa
is
Gg
nL
Lx
Qx
Qx
Qx
Qx
Qx
Qx
fO
Qx
Tc
"}
(19,1,1) = {"
xt
Qx
Qx
sI
Qx
Qx
Qx
Qx
Qx
Qx
Qx
Qx
Qx
Qx
Qx
Qx
Xm
sj
VI
jj
yi
wV
wV
cy
wV
wV
Rk
Qx
Qx
Qx
Qx
Qx
Qx
Qx
Qx
Tc
"}
(20,1,1) = {"
xt
Qx
Qx
Qx
Qx
Hp
Qx
Qx
Qx
Qx
Qx
Qx
Qx
Qx
Qx
Qx
yi
Xu
uq
xC
wV
wV
tc
is
is
vx
kN
fO
Qx
Qx
Qx
fO
Qx
Qx
Qx
xt
"}
(21,1,1) = {"
xt
Qx
Qx
Qx
Qx
Qx
Qx
Qx
Qx
Qx
Qx
sI
Qx
Qx
Qx
Qx
fB
oo
uq
xC
wV
wV
wV
Ai
is
Qx
Qx
Qx
Qx
Qx
Qx
Qx
Qx
Qx
Qx
xt
"}
(22,1,1) = {"
xt
Qx
Qx
Qx
Qx
Qx
Qx
Qx
Qx
Qx
Qx
Qx
Qx
Qx
Qx
Qx
fB
th
fd
mp
kn
kn
wV
Ai
is
Qx
Qx
sI
Qx
Qx
Qx
Qx
Hp
Qx
Qx
xt
"}
(23,1,1) = {"
xt
Qx
Qx
Qx
sI
Qx
Qx
Qx
Qx
Qx
Qx
Qx
Hp
Qx
Qx
Qx
is
is
is
is
is
is
Gv
is
is
Qx
Qx
Qx
Qx
Qx
Qx
Qx
Qx
Qx
Qx
xt
"}
(24,1,1) = {"
xt
Qx
Qx
Qx
Qx
Qx
Qx
Qx
Qx
Qx
Qx
Qx
Qx
Qx
Qx
Qx
dt
wB
wB
wB
uC
UQ
uG
nJ
is
Qx
Qx
Qx
Qx
Qx
Qx
Qx
Qx
Qx
Qx
xt
"}
(25,1,1) = {"
xt
xt
Qx
Qx
Qx
Qx
Hp
Qx
Qx
Qx
Qx
Qx
Qx
Qx
Qx
Qx
dt
wB
vF
wB
uC
uG
uG
EE
is
Qx
Qx
Qx
Qx
Qx
Qx
Qx
Qx
Qx
Qx
xt
"}
(26,1,1) = {"
xt
xt
Qx
Qx
Qx
Qx
Qx
Qx
Qx
Qx
Qx
Qx
Qx
Qx
sI
Qx
dt
wB
wB
wB
Iz
uG
Tv
aJ
is
Qx
Qx
Qx
Qx
Qx
Qx
Qx
Qx
sI
Qx
xt
"}
(27,1,1) = {"
xt
xt
Qx
Qx
sI
Qx
Qx
Qx
Qx
Qx
Qx
Qx
Qx
Qx
Qx
Qx
is
iB
iB
iB
is
LY
LY
LY
is
sI
Qx
Qx
Qx
Qx
Qx
Qx
Qx
Qx
Qx
xt
"}
(28,1,1) = {"
xt
xt
Qx
Qx
Qx
Qx
Qx
Qx
Qx
Qx
Qx
Qx
Qx
Qx
Qx
Qx
Qx
Qx
Qx
Qx
Qx
Qx
Qx
Qx
Qx
Qx
Qx
Qx
Qx
Qx
Qx
Qx
Qx
Qx
Qx
xt
"}
(29,1,1) = {"
xt
xt
Qx
Qx
Qx
Qx
XS
Qx
Qx
Qx
Qx
Qx
Qx
Qx
Qx
Qx
Qx
Qx
Qx
Qx
Qx
Qx
Qx
Qx
Qx
Qx
Qx
Qx
Qx
Qx
Qx
XS
Qx
Qx
Qx
xt
"}
(30,1,1) = {"
xt
xt
Qx
Qx
Qx
Qx
Qx
Qx
Qx
Qx
Qx
Qx
Qx
Qx
Qx
Qx
Qx
Qx
XS
Qx
Qx
Qx
sI
Qx
Qx
Qx
Qx
Qx
Qx
Qx
Qx
Qx
Qx
Qx
Qx
xt
"}
(31,1,1) = {"
xt
xt
Qx
Qx
Qx
sI
Qx
Qx
Qx
Qx
Qx
Qx
Qx
Qx
sI
Qx
Qx
Qx
Qx
Qx
Qx
Qx
Qx
Qx
Qx
Qx
Hp
Qx
Qx
Qx
Qx
Qx
Qx
Qx
xt
xt
"}
(32,1,1) = {"
xt
xt
xt
Qx
Qx
Qx
Qx
Qx
Qx
Qx
Qx
Qx
Qx
Qx
Qx
Qx
Qx
Hp
Qx
Qx
sI
Qx
Qx
Qx
Qx
Qx
Qx
Qx
Qx
Qx
Qx
Qx
Qx
Qx
xt
xt
"}
(33,1,1) = {"
xt
xt
xt
Qx
Qx
Qx
Qx
sI
Qx
Qx
Hp
Qx
Qx
Qx
Qx
Qx
Qx
Qx
Qx
Qx
Qx
Qx
Qx
Qx
Qx
Qx
Qx
Qx
sI
Qx
Qx
Qx
Qx
xt
xt
xt
"}
(34,1,1) = {"
xt
xt
xt
xt
Qx
Qx
Qx
Qx
Qx
Qx
Qx
Qx
xt
xt
xt
xt
Qx
Qx
Qx
Qx
Qx
Qx
Qx
Qx
Qx
Qx
Qx
Qx
Qx
Qx
Qx
xt
xt
xt
xt
xt
"}
(35,1,1) = {"
xt
xt
xt
xt
xt
xt
xt
Qx
Qx
xt
xt
xt
xt
xt
xt
xt
xt
xt
xt
xt
Qx
Qx
Qx
Qx
Qx
Qx
Qx
xt
xt
xt
xt
xt
xt
xt
xt
xt
"}
(36,1,1) = {"
xt
xt
xt
xt
xt
xt
xt
xt
xt
xt
xt
xt
xt
xt
xt
xt
xt
xt
xt
xt
xt
xt
xt
xt
xt
xt
xt
xt
xt
xt
xt
xt
xt
xt
xt
xt
"}
