//MAP CONVERTED BY dmm2tgm.py THIS HEADER COMMENT PREVENTS RECONVERSION, DO NOT REMOVE
"ae" = (
/obj/structure/lattice,
/turf/template_noop,
/area/space/nearstation)
"ah" = (
/obj/item/stack/tile/iron/base,
/obj/item/stack/rods,
/turf/template_noop,
/area/space/nearstation)
"aB" = (
/obj/item/stack/sheet/iron,
/turf/template_noop,
/area/space/nearstation)
"aE" = (
/obj/effect/spawner/random/structure/tank_holder,
/turf/open/floor/plating/airless,
/area/ruin/space/has_grav)
"bp" = (
/obj/effect/turf_decal/tile/yellow,
/turf/open/floor/iron/white/airless,
/area/ruin/space/has_grav)
"bC" = (
/obj/structure/lattice,
/obj/item/light/tube/broken,
/turf/template_noop,
/area/space/nearstation)
"bS" = (
/turf/open/floor/carpet/airless,
/area/ruin/space/has_grav)
"bU" = (
/obj/effect/turf_decal/tile/yellow/anticorner/contrasted{
	dir = 4
	},
/turf/open/floor/iron/white/airless,
/area/ruin/space/has_grav)
"cD" = (
/obj/structure/lattice,
/obj/structure/door_assembly/door_assembly_med,
/turf/template_noop,
/area/ruin/space/has_grav)
"cZ" = (
/obj/structure/lattice,
/obj/structure/girder/displaced,
/turf/template_noop,
/area/space/nearstation)
"dy" = (
/obj/effect/mapping_helpers/broken_floor,
/turf/open/floor/plating/airless,
/area/ruin/space/has_grav)
"dV" = (
/obj/effect/turf_decal/tile/blue{
	dir = 4
	},
/turf/open/floor/iron/white/corner/airless,
/area/ruin/space/has_grav)
"ea" = (
/obj/effect/spawner/random/engineering/atmospherics_portable,
/turf/open/floor/plating/airless,
/area/ruin/space/has_grav)
"eK" = (
/obj/item/shard,
/turf/open/floor/iron/white/airless,
/area/ruin/space/has_grav)
"eP" = (
/turf/closed/wall,
/area/ruin/space/has_grav)
"fc" = (
/obj/structure/disposalpipe/broken{
	dir = 8
	},
/obj/effect/mapping_helpers/broken_floor,
/turf/open/floor/plating/airless,
/area/ruin/space/has_grav)
"fW" = (
/obj/effect/spawner/random/medical/patient_stretcher,
/obj/effect/spawner/random/medical/minor_healing,
/obj/effect/mapping_helpers/broken_floor,
/turf/open/floor/plating/airless,
/area/ruin/space/has_grav)
"gi" = (
/obj/effect/spawner/random/structure/girder,
/turf/open/floor/plating/airless,
/area/ruin/space/has_grav)
"gk" = (
/obj/structure/closet/emcloset,
/obj/item/gps/spaceruin,
/turf/open/floor/iron/airless,
/area/ruin/space/has_grav)
"gH" = (
/obj/structure/lattice,
/obj/item/stack/tile/iron/base,
/obj/item/stack/sheet/iron,
/turf/template_noop,
/area/space/nearstation)
"gK" = (
/obj/structure/closet/cabinet,
/obj/item/storage/pill_bottle/happy,
/obj/item/clothing/ears/earmuffs,
/turf/open/floor/wood/airless,
/area/ruin/space/has_grav)
"gZ" = (
/obj/item/stack/tile/iron/base,
/turf/template_noop,
/area/space/nearstation)
"iB" = (
/obj/item/shard,
/obj/effect/turf_decal/tile/yellow{
	dir = 4
	},
/turf/open/floor/iron/white/airless,
/area/ruin/space/has_grav)
"jb" = (
/obj/item/stack/rods,
/turf/template_noop,
/area/space/nearstation)
"jk" = (
/obj/effect/turf_decal/tile/blue{
	dir = 1
	},
/turf/open/floor/iron/white/corner/airless{
	dir = 8
	},
/area/ruin/space/has_grav)
"kI" = (
/obj/structure/chair/sofa/left/brown,
/turf/open/floor/carpet/airless,
/area/ruin/space/has_grav)
"lU" = (
/obj/item/stack/tile/iron/base,
/obj/effect/mapping_helpers/broken_floor,
/turf/open/floor/plating/airless,
/area/ruin/space/has_grav)
"nf" = (
/turf/open/floor/iron/airless,
/area/ruin/space/has_grav)
"nh" = (
/obj/structure/lattice,
/obj/item/stack/sheet/iron,
/turf/template_noop,
/area/space/nearstation)
"oy" = (
/obj/structure/table_frame,
/obj/effect/turf_decal/tile/yellow/opposingcorners{
	dir = 1
	},
/turf/open/floor/iron/checker/airless,
/area/ruin/space/has_grav)
"oX" = (
/obj/structure/door_assembly/door_assembly_med,
/turf/open/floor/plating/airless,
/area/ruin/space/has_grav)
"pc" = (
/obj/effect/spawner/random/engineering/tank,
/obj/effect/mapping_helpers/broken_floor,
/turf/open/floor/plating/airless,
/area/ruin/space/has_grav)
"pr" = (
/obj/effect/mapping_helpers/burnt_floor,
/turf/open/floor/plating/airless,
/area/ruin/space/has_grav)
"pR" = (
/obj/item/reagent_containers/applicator/pill/maintenance,
/turf/open/floor/plating/airless,
/area/ruin/space/has_grav)
"rt" = (
/obj/item/stack/rods,
/turf/open/floor/plating/airless,
/area/ruin/space/has_grav)
"rN" = (
/obj/structure/girder/displaced,
/turf/open/floor/plating/airless,
/area/ruin/space/has_grav)
"tB" = (
/obj/structure/lattice,
/obj/structure/table_frame,
/turf/template_noop,
/area/space/nearstation)
"tF" = (
/obj/structure/grille/broken,
/obj/effect/decal/cleanable/glass,
/obj/item/stack/rods,
/obj/effect/mapping_helpers/broken_floor,
/turf/open/floor/plating/airless,
/area/ruin/space/has_grav)
"uB" = (
/obj/structure/disposalpipe/broken{
	dir = 1
	},
/obj/effect/mapping_helpers/broken_floor,
/turf/open/floor/plating/airless,
/area/ruin/space/has_grav)
"uV" = (
/obj/structure/lattice,
/obj/item/stack/tile/wood,
/turf/template_noop,
/area/space/nearstation)
"vW" = (
/obj/structure/extinguisher_cabinet/directional/north,
/obj/effect/mapping_helpers/broken_floor,
/turf/open/floor/iron/airless,
/area/ruin/space/has_grav)
"wT" = (
/obj/effect/spawner/structure/window/reinforced,
/turf/open/floor/plating/airless,
/area/ruin/space/has_grav)
"xk" = (
/obj/structure/disposalpipe/broken{
	dir = 8
	},
/turf/open/floor/plating/airless,
/area/ruin/space/has_grav)
"xB" = (
/obj/structure/girder/displaced,
/obj/structure/lattice,
/turf/template_noop,
/area/space/nearstation)
"xP" = (
/obj/structure/lattice,
/obj/effect/spawner/random/structure/crate_abandoned,
/turf/template_noop,
/area/space/nearstation)
"xW" = (
/obj/item/stack/tile/wood,
/turf/template_noop,
/area/space/nearstation)
"yh" = (
/obj/structure/lattice,
/obj/item/wallframe/intercom,
/obj/item/stack/rods,
/turf/template_noop,
/area/space/nearstation)
"zw" = (
/obj/effect/spawner/random/structure/table_or_rack,
/obj/effect/mapping_helpers/broken_floor,
/turf/open/floor/plating/airless,
/area/ruin/space/has_grav)
"AV" = (
/turf/open/floor/wood/airless,
/area/ruin/space/has_grav)
"AY" = (
/obj/structure/door_assembly,
/turf/open/floor/iron/airless,
/area/ruin/space/has_grav)
"BX" = (
/obj/structure/disposalpipe/broken{
	dir = 4
	},
/obj/effect/mapping_helpers/broken_floor,
/turf/open/floor/plating/airless,
/area/ruin/space/has_grav)
"Ca" = (
/obj/machinery/medical_kiosk,
/obj/effect/turf_decal/tile/yellow{
	dir = 4
	},
/turf/open/floor/iron/white/airless,
/area/ruin/space/has_grav)
"Cc" = (
/obj/machinery/light/broken/directional/west,
/obj/effect/turf_decal/tile/blue{
	dir = 1
	},
/turf/open/floor/iron/white/corner/airless{
	dir = 8
	},
/area/ruin/space/has_grav)
"Cg" = (
/obj/machinery/door/firedoor/closed,
/obj/machinery/door/airlock/public/glass,
/turf/open/floor/iron/dark/airless,
/area/ruin/space/has_grav)
"Co" = (
/obj/effect/turf_decal/trimline/neutral/warning{
	dir = 1
	},
/obj/item/computer_disk/ordnance,
/turf/open/floor/iron/dark/side/airless{
	dir = 1
	},
/area/ruin/space/has_grav)
"Cq" = (
/obj/structure/lattice,
/obj/item/stack/tile/iron/base,
/obj/structure/disposalpipe/broken,
/turf/template_noop,
/area/space/nearstation)
"Di" = (
/obj/structure/frame/machine,
/obj/item/circuitboard/machine/vendor,
/obj/machinery/light/broken/directional/south,
/obj/effect/mapping_helpers/broken_floor,
/turf/open/floor/plating/airless,
/area/ruin/space/has_grav)
"DY" = (
/turf/template_noop,
/area/template_noop)
"EE" = (
/obj/effect/spawner/random/trash/botanical_waste,
/obj/effect/mapping_helpers/broken_floor,
/turf/open/floor/plating/airless,
/area/ruin/space/has_grav)
"EK" = (
/obj/structure/lattice,
/obj/item/shard,
/turf/template_noop,
/area/space/nearstation)
"FQ" = (
/obj/effect/mapping_helpers/broken_floor,
/turf/open/floor/iron/airless,
/area/ruin/space/has_grav)
"Gb" = (
/obj/item/shard,
/obj/effect/mapping_helpers/broken_floor,
/turf/open/floor/plating/airless,
/area/ruin/space/has_grav)
"Gn" = (
/obj/structure/lattice,
/obj/machinery/light/broken/directional/north,
/turf/template_noop,
/area/space/nearstation)
"Gv" = (
/obj/effect/spawner/random/medical/surgery_tool,
/turf/template_noop,
/area/space/nearstation)
"GP" = (
/obj/structure/table/wood,
/obj/item/flashlight/lamp/green,
/turf/open/floor/carpet/airless,
/area/ruin/space/has_grav)
"Il" = (
/obj/structure/disposalpipe/segment,
/obj/machinery/door/airlock/public/glass,
/turf/open/floor/iron/dark/airless,
/area/ruin/space/has_grav)
"IE" = (
/obj/structure/grille/broken,
/obj/effect/decal/cleanable/glass,
/obj/effect/mapping_helpers/broken_floor,
/turf/open/floor/plating/airless,
/area/ruin/space/has_grav)
"IR" = (
/obj/effect/decal/cleanable/glass,
/obj/structure/grille,
/turf/open/floor/plating/airless,
/area/ruin/space/has_grav)
"Jy" = (
/obj/structure/closet,
/obj/effect/spawner/random/maintenance/three,
/obj/effect/mapping_helpers/broken_floor,
/turf/open/floor/plating/airless,
/area/ruin/space/has_grav)
"JI" = (
/obj/structure/door_assembly,
/obj/structure/disposalpipe/segment{
	dir = 4
	},
/turf/open/floor/iron/airless,
/area/ruin/space/has_grav)
"JN" = (
/obj/structure/disposalpipe/broken{
	dir = 4
	},
/obj/structure/disposalpipe/broken{
	dir = 8
	},
/obj/effect/mapping_helpers/broken_floor,
/turf/open/floor/plating/airless,
/area/ruin/space/has_grav)
"JQ" = (
/obj/structure/sign/directions/medical/directional/east,
/turf/closed/wall,
/area/ruin/space/has_grav)
"Ke" = (
/obj/item/stack/rods,
/obj/effect/mapping_helpers/broken_floor,
/turf/open/floor/plating/airless,
/area/ruin/space/has_grav)
"Kt" = (
/obj/structure/disposalpipe/broken{
	dir = 1
	},
/turf/open/floor/plating/airless,
/area/ruin/space/has_grav)
"KQ" = (
/obj/structure/lattice,
/obj/item/vending_refill/assist,
/turf/template_noop,
/area/space/nearstation)
"La" = (
/obj/structure/table,
/obj/effect/spawner/random/entertainment/toy,
/turf/open/floor/iron/airless,
/area/ruin/space/has_grav)
"Lc" = (
/turf/open/floor/iron/white/airless,
/area/ruin/space/has_grav)
"Lg" = (
/obj/item/stack/rods,
/turf/open/floor/wood/airless,
/area/ruin/space/has_grav)
"Lz" = (
/obj/structure/girder/displaced,
/turf/template_noop,
/area/space/nearstation)
"My" = (
/obj/machinery/cell_charger,
/obj/structure/table,
/obj/item/stack/rods,
/turf/open/floor/iron/airless,
/area/ruin/space/has_grav)
"Nw" = (
/obj/item/shard,
/turf/open/floor/iron/airless,
/area/ruin/space/has_grav)
"NN" = (
/obj/effect/turf_decal/trimline/neutral/warning{
	dir = 1
	},
/obj/structure/disposalpipe/segment,
/obj/structure/firelock_frame,
/turf/open/floor/iron/dark/side/airless{
	dir = 1
	},
/area/ruin/space/has_grav)
"OZ" = (
/obj/structure/lattice,
/obj/item/wallframe/apc,
/turf/template_noop,
/area/space/nearstation)
"Pn" = (
/obj/machinery/disposal/bin,
/obj/structure/disposalpipe/trunk{
	dir = 1
	},
/turf/open/floor/iron/dark/airless,
/area/ruin/space/has_grav)
"Qy" = (
/obj/item/wallframe/airalarm,
/obj/structure/disposalpipe/segment{
	dir = 6
	},
/turf/open/floor/iron/white/corner/airless{
	dir = 8
	},
/area/ruin/space/has_grav)
"QV" = (
/turf/open/floor/plating/airless,
/area/ruin/space/has_grav)
"Ri" = (
/obj/structure/chair/comfy/beige,
/turf/open/floor/carpet/airless,
/area/ruin/space/has_grav)
"Si" = (
/obj/structure/disposalpipe/segment,
/obj/effect/turf_decal/tile/blue{
	dir = 1
	},
/turf/open/floor/iron/white/corner/airless{
	dir = 8
	},
/area/ruin/space/has_grav)
"Sz" = (
/obj/item/wallframe/firealarm,
/obj/effect/mapping_helpers/broken_floor,
/turf/open/floor/plating/airless,
/area/ruin/space/has_grav)
"SE" = (
/obj/structure/disposalpipe/segment{
	dir = 4
	},
/turf/open/floor/iron/airless,
/area/ruin/space/has_grav)
"Tb" = (
/obj/effect/turf_decal/trimline/neutral/corner{
	dir = 4
	},
/turf/open/floor/iron/dark/corner/airless{
	dir = 4
	},
/area/ruin/space/has_grav)
"TE" = (
/obj/structure/lattice,
/obj/item/stack/tile/iron/base,
/turf/template_noop,
/area/space/nearstation)
"Ua" = (
/obj/structure/door_assembly/door_assembly_mai,
/turf/open/floor/plating/airless,
/area/ruin/space/has_grav)
"Vn" = (
/obj/effect/decal/cleanable/glass,
/obj/structure/grille,
/obj/effect/mapping_helpers/broken_floor,
/turf/open/floor/plating/airless,
/area/ruin/space/has_grav)
"Wr" = (
/obj/structure/door_assembly/door_assembly_mai,
/obj/effect/mapping_helpers/broken_floor,
/turf/open/floor/plating/airless,
/area/ruin/space/has_grav)
"WX" = (
/obj/effect/spawner/random/vending/colavend,
/obj/effect/mapping_helpers/broken_floor,
/turf/open/floor/plating/airless,
/area/ruin/space/has_grav)
"Xq" = (
/obj/structure/lattice,
/obj/item/stack/rods,
/turf/template_noop,
/area/space/nearstation)
"Xx" = (
/obj/item/shard,
/turf/template_noop,
/area/space/nearstation)
"Yt" = (
/obj/effect/turf_decal/tile/blue,
/turf/open/floor/iron/white/airless,
/area/ruin/space/has_grav)

(1,1,1) = {"
DY
DY
DY
gi
ae
ae
ae
ae
gi
DY
DY
DY
DY
"}
(2,1,1) = {"
DY
eP
dy
eP
eP
jb
ae
DY
DY
Xx
jb
DY
DY
"}
(3,1,1) = {"
DY
eP
My
La
eP
gi
ae
eP
xB
Vn
EK
eP
tF
"}
(4,1,1) = {"
gi
eP
nf
nf
Qy
Si
uB
jk
Xq
dy
jk
Cc
dy
"}
(5,1,1) = {"
dy
Ua
nf
FQ
SE
Sz
ae
EK
dy
FQ
Ke
TE
EK
"}
(6,1,1) = {"
ae
gi
FQ
nf
JN
QV
gZ
ah
QV
dV
dV
dV
dV
"}
(7,1,1) = {"
rN
eP
JQ
AY
JI
IE
gi
cZ
Ua
xB
Xq
IE
IR
"}
(8,1,1) = {"
eP
ea
eP
nf
fc
Nw
eP
xP
ae
QV
xB
Xx
DY
"}
(9,1,1) = {"
ae
rt
Ua
nf
ae
FQ
cZ
Jy
dy
nh
ae
DY
DY
"}
(10,1,1) = {"
ae
Ke
eP
vW
BX
nf
gi
ae
dy
zw
eP
jb
DY
"}
(11,1,1) = {"
ae
QV
rN
FQ
SE
dy
gi
nh
ae
eP
xB
eP
DY
"}
(12,1,1) = {"
dy
rt
gi
ae
xk
dy
eP
pR
Xq
EE
ae
ae
DY
"}
(13,1,1) = {"
QV
dy
eP
Gn
TE
OZ
xB
aE
ae
eP
QV
Ke
DY
"}
(14,1,1) = {"
dy
eP
eP
yh
aB
ae
eP
eP
xB
gi
Wr
gi
DY
"}
(15,1,1) = {"
pc
eP
gk
nf
QV
gH
tB
dy
GP
bS
AV
wT
DY
"}
(16,1,1) = {"
gi
eP
Tb
FQ
Ke
KQ
WX
eP
kI
bS
Lg
wT
DY
"}
(17,1,1) = {"
ae
Cg
Co
FQ
dy
DY
Di
eP
Ri
bS
uV
uV
DY
"}
(18,1,1) = {"
DY
Il
NN
Kt
cD
Cq
Pn
eP
gK
ae
ae
lU
DY
"}
(19,1,1) = {"
ae
eP
eP
gi
dy
ae
Vn
rN
eP
TE
Ke
jb
DY
"}
(20,1,1) = {"
jb
ae
gi
Ca
Lc
Gb
Xx
bC
eK
QV
ae
xW
DY
"}
(21,1,1) = {"
DY
ae
oy
iB
Lc
Ke
ae
dy
Lc
Yt
QV
jb
DY
"}
(22,1,1) = {"
jb
Xx
IE
bU
bp
ae
Xq
ae
fW
Yt
ae
DY
DY
"}
(23,1,1) = {"
DY
gi
eP
eP
ae
ae
dy
oX
Lz
eP
eP
Gv
DY
"}
(24,1,1) = {"
DY
DY
jb
gi
DY
dy
Gv
ae
ae
ae
DY
DY
DY
"}
(25,1,1) = {"
DY
DY
DY
ae
pr
ae
ae
dy
DY
DY
DY
DY
DY
"}
