//MAP CONVERTED BY dmm2tgm.py THIS HEADER COMMENT PREVENTS RECONVERSION, DO NOT REMOVE
"a" = (
/obj/machinery/computer/operating,
/turf/open/floor/plastic,
/area/template_noop)
"b" = (
/obj/effect/spawner/random/medical/patient_stretcher,
/turf/open/floor/plastic,
/area/template_noop)
"c" = (
/turf/open/floor/plastic,
/area/template_noop)
"f" = (
/turf/closed/wall/prefab_plastic,
/area/template_noop)
"g" = (
/obj/item/wallframe/defib_mount/charging,
/obj/item/defibrillator,
/obj/item/stock_parts/power_store/cell/upgraded/plus,
/obj/structure/closet/crate/deforest,
/obj/item/wallframe/frontier_medstation,
/obj/item/stack/sheet/plastic_wall_panel/ten,
/turf/open/floor/plastic,
/area/template_noop)
"h" = (
/obj/structure/table/reinforced/rglass,
/obj/item/reagent_containers/cup/bottle/epinephrine,
/obj/item/reagent_containers/cup/bottle/formaldehyde,
/obj/item/storage/backpack/duffelbag/deforest_surgical/stocked,
/obj/item/storage/box/syringes,
/turf/open/floor/plastic,
/area/template_noop)
"L" = (
/obj/structure/mineral_door/manual_colony_door,
/turf/open/floor/plastic,
/area/template_noop)

(1,1,1) = {"
f
f
L
f
f
"}
(2,1,1) = {"
f
h
c
g
f
"}
(3,1,1) = {"
f
a
c
b
f
"}
(4,1,1) = {"
f
b
c
b
f
"}
(5,1,1) = {"
f
f
f
f
f
"}
