//MAP CONVERTED BY dmm2tgm.py THIS HEADER COMMENT PREVENTS RECONVERSION, DO NOT REMOVE
"a" = (
/turf/closed/wall/prefab_plastic,
/area/template_noop)

(1,1,1) = {"
a
"}
(2,1,1) = {"
a
"}
(3,1,1) = {"
a
"}
