//MAP CONVERTED BY dmm2tgm.py THIS HEADER COMMENT PREVENTS RECONVERSION, DO NOT REMOVE
"a" = (
/obj/structure/window/reinforced/survival_pod,
/obj/structure/window/reinforced/survival_pod{
	dir = 8
	},
/obj/machinery/power/port_gen/pacman/pre_loaded,
/turf/open/floor/plastic,
/area/template_noop)
"b" = (
/obj/structure/window/reinforced/survival_pod,
/obj/structure/window/reinforced/survival_pod{
	dir = 8
	},
/obj/machinery/atmospherics/components/unary/passive_vent,
/obj/effect/turf_decal/trimline/dark_blue/filled,
/turf/open/floor/plastic,
/area/template_noop)
"c" = (
/obj/machinery/door/window/survival_pod/left/directional/south,
/obj/machinery/pipedispenser,
/obj/structure/fans/tiny,
/obj/machinery/atmospherics/pipe/layer_manifold/scrubbers/visible,
/turf/open/floor/plastic,
/area/template_noop)
"o" = (
/obj/machinery/door/window/survival_pod/left/directional/west,
/obj/structure/fans/tiny,
/obj/machinery/atmospherics/pipe/smart/simple/scrubbers/visible{
	dir = 5
	},
/turf/open/floor/plastic,
/area/template_noop)
"v" = (
/turf/closed/wall/prefab_plastic,
/area/template_noop)
"A" = (
/obj/structure/window/reinforced/survival_pod,
/obj/structure/window/reinforced/survival_pod{
	dir = 4
	},
/obj/machinery/atmospherics/components/unary/passive_vent,
/obj/effect/turf_decal/trimline/dark_red/filled,
/turf/open/floor/plastic,
/area/template_noop)
"F" = (
/obj/structure/closet/crate/nakamura,
/obj/item/wallframe/apc,
/obj/item/electronics/apc,
/obj/item/stack/cable_coil/thirty,
/obj/item/stock_parts/power_store/cell/upgraded/plus,
/obj/item/flatpacked_machine/wind_turbine,
/obj/item/flatpacked_machine/co2_cracker,
/obj/item/flatpacked_machine/gps_beacon,
/obj/item/flatpacked_machine/recycler,
/obj/item/flatpacked_machine/ore_silo,
/obj/item/multitool,
/obj/item/stack/sheet/iron/ten,
/obj/item/storage/toolbox/mechanical,
/obj/item/clothing/glasses/welding,
/obj/item/weldingtool/electric/arc_welder,
/obj/machinery/atmospherics/pipe/smart/manifold/scrubbers/visible{
	dir = 1
	},
/obj/item/reagent_containers/cup/soda_cans/grey_bull,
/obj/item/oxygen_candle,
/obj/item/oxygen_candle,
/obj/item/oxygen_candle,
/obj/item/oxygen_candle,
/obj/item/oxygen_candle,
/obj/item/oxygen_candle,
/obj/item/oxygen_candle,
/obj/item/oxygen_candle,
/obj/item/oxygen_candle,
/obj/item/oxygen_candle,
/obj/item/oxygen_candle,
/obj/item/oxygen_candle,
/obj/item/wallframe/wall_heater,
/turf/open/floor/plastic,
/area/template_noop)
"N" = (
/obj/structure/window/reinforced/survival_pod,
/obj/machinery/atmospherics/pipe/layer_manifold/supply,
/obj/structure/window/reinforced/survival_pod{
	dir = 4
	},
/turf/open/floor/plastic,
/area/template_noop)
"V" = (
/obj/machinery/door/window/survival_pod/left/directional/east,
/obj/machinery/atmospherics/components/trinary/filter/atmos,
/obj/structure/fans/tiny,
/turf/open/floor/plastic,
/area/template_noop)

(1,1,1) = {"
A
o
a
"}
(2,1,1) = {"
v
F
c
"}
(3,1,1) = {"
b
V
N
"}
