//MAP CONVERTED BY dmm2tgm.py THIS HEADER COMMENT PREVENTS RECONVERSION, DO NOT REMOVE
"a" = (
/turf/closed/wall/prefab_plastic,
/area/template_noop)
"c" = (
/obj/machinery/cell_charger_multi/wall_mounted/directional/north,
/obj/item/stock_parts/power_store/cell/upgraded/plus,
/obj/machinery/electrolyzer/co2_cracker,
/obj/effect/turf_decal/delivery,
/turf/open/floor/plastic,
/area/template_noop)
"g" = (
/obj/structure/window/fulltile/colony_fabricator,
/turf/open/floor/plastic,
/area/template_noop)
"h" = (
/obj/machinery/atmospherics/components/unary/passive_vent,
/turf/open/floor/plastic,
/area/template_noop)
"k" = (
/turf/open/floor/plastic,
/area/template_noop)
"v" = (
/obj/machinery/atmospherics/components/unary/portables_connector/visible{
	dir = 8
	},
/obj/machinery/portable_atmospherics/scrubber,
/obj/effect/turf_decal/delivery/blue,
/turf/open/floor/plastic,
/area/template_noop)
"B" = (
/obj/structure/mineral_door/manual_colony_door,
/turf/open/floor/plastic,
/area/template_noop)
"D" = (
/obj/item/flatpacked_machine/thermomachine,
/obj/effect/turf_decal/delivery/red,
/turf/open/floor/plastic,
/area/template_noop)
"E" = (
/obj/machinery/suit_storage_unit,
/obj/item/tank/internals/emergency_oxygen,
/turf/open/floor/plastic,
/area/template_noop)
"N" = (
/obj/machinery/atmospherics/pipe/smart/manifold/supply/visible,
/obj/structure/table/reinforced/titaniumglass,
/obj/item/stack/sheet/plastic/five,
/obj/item/stack/sheet/plastic/five,
/obj/item/flatpacked_machine/shutter_kit,
/obj/item/flatpacked_machine/shutter_kit,
/obj/item/flatpacked_machine/shutter_kit,
/obj/item/flatpacked_machine/shutter_kit,
/obj/item/assembly/control,
/obj/item/wallframe/button,
/obj/item/wrench,
/obj/item/book/manual/wiki/atmospherics,
/obj/item/screwdriver,
/turf/open/floor/plastic,
/area/template_noop)

(1,1,1) = {"
a
g
B
g
a
"}
(2,1,1) = {"
a
E
k
D
a
"}
(3,1,1) = {"
a
c
h
N
a
"}
(4,1,1) = {"
a
E
k
v
a
"}
(5,1,1) = {"
a
g
B
g
a
"}
