//MAP CONVERTED BY dmm2tgm.py THIS HEADER COMMENT PREVENTS RECONVERSION, DO NOT REMOVE
"a" = (
/turf/open/floor/plastic,
/area/template_noop)
"f" = (
/obj/machinery/conveyor{
	dir = 4
	},
/turf/open/floor/plastic,
/area/template_noop)
"g" = (
/obj/structure/closet/crate/engineering{
	name = "Routing supplies"
	},
/obj/item/stack/conveyor/thirty,
/obj/item/stack/conveyor/thirty,
/obj/item/conveyor_switch_construct,
/obj/item/conveyor_switch_construct,
/obj/item/conveyor_switch_construct,
/turf/open/floor/plastic,
/area/template_noop)
"i" = (
/obj/structure/closet/crate/engineering{
	name = "Additional Circuits"
	},
/obj/item/circuitboard/machine/manucrafter,
/obj/item/circuitboard/machine/manucrafter,
/obj/item/circuitboard/machine/manucrafter,
/obj/item/circuitboard/machine/manucrafter,
/obj/item/circuitboard/machine/manucrafter,
/obj/item/circuitboard/machine/manucrafter,
/obj/item/circuitboard/machine/manulathe,
/obj/item/circuitboard/machine/manulathe,
/obj/item/circuitboard/machine/manulathe,
/obj/item/circuitboard/machine/manulathe,
/obj/item/circuitboard/machine/manulathe,
/obj/item/circuitboard/machine/manulathe,
/obj/item/circuitboard/machine/manusmelter,
/obj/item/circuitboard/machine/manusmelter,
/obj/item/circuitboard/machine/manusmelter,
/obj/item/circuitboard/machine/manusmelter,
/obj/item/circuitboard/machine/manurouter,
/obj/item/circuitboard/machine/manurouter,
/obj/item/circuitboard/machine/manurouter,
/obj/item/circuitboard/machine/manurouter,
/obj/item/circuitboard/machine/manurouter,
/obj/item/circuitboard/machine/manurouter,
/obj/item/circuitboard/machine/manusorter,
/obj/item/circuitboard/machine/manusorter,
/obj/item/circuitboard/machine/manusorter,
/obj/item/circuitboard/machine/manusorter,
/obj/item/circuitboard/machine/manusorter,
/obj/item/circuitboard/machine/manusorter,
/obj/item/circuitboard/machine/manusorter,
/obj/item/circuitboard/machine/manuunloader,
/obj/item/circuitboard/machine/manuunloader,
/obj/item/circuitboard/machine/manuunloader,
/obj/item/circuitboard/machine/manuunloader,
/obj/item/circuitboard/machine/manuunloader,
/obj/item/circuitboard/machine/manuunloader,
/obj/item/circuitboard/machine/manucrusher,
/obj/item/circuitboard/machine/manucrusher,
/obj/item/circuitboard/machine/manucrusher,
/obj/item/circuitboard/machine/manucrusher,
/obj/item/circuitboard/machine/manucrusher,
/obj/item/circuitboard/machine/manucrusher,
/obj/item/circuitboard/machine/big_manipulator,
/obj/item/circuitboard/machine/big_manipulator,
/obj/item/circuitboard/machine/big_manipulator,
/obj/item/circuitboard/machine/big_manipulator,
/obj/item/circuitboard/machine/big_manipulator,
/obj/item/circuitboard/machine/big_manipulator,
/obj/item/circuitboard/machine/big_manipulator,
/obj/item/circuitboard/machine/big_manipulator,
/turf/open/floor/plastic,
/area/template_noop)
"j" = (
/obj/machinery/power/manufacturing/lathe,
/turf/open/floor/plastic,
/area/template_noop)
"m" = (
/obj/machinery/power/manufacturing/smelter,
/turf/open/floor/plastic,
/area/template_noop)
"p" = (
/obj/machinery/power/smes/battery_pack/precharged,
/turf/open/floor/plastic,
/area/template_noop)
"s" = (
/obj/machinery/conveyor{
	dir = 8
	},
/turf/open/floor/plastic,
/area/template_noop)
"v" = (
/obj/machinery/power/manufacturing/crusher,
/turf/open/floor/plastic,
/area/template_noop)
"w" = (
/obj/machinery/power/manufacturing/unloader,
/turf/open/floor/plastic,
/area/template_noop)
"y" = (
/obj/machinery/conveyor,
/turf/open/floor/plastic,
/area/template_noop)
"A" = (
/obj/machinery/power/manufacturing/storagebox,
/turf/open/floor/plastic,
/area/template_noop)
"C" = (
/turf/closed/wall/prefab_plastic,
/area/template_noop)
"E" = (
/obj/item/wallframe/apc,
/obj/item/stack/cable_coil/thirty,
/obj/item/flatpacked_machine/airlock_kit_manual,
/obj/item/flatpacked_machine/airlock_kit_manual,
/obj/item/flatpacked_machine/airlock_kit_manual,
/obj/item/flatpacked_machine/airlock_kit_manual,
/obj/item/flatpacked_machine/airlock_kit_manual,
/obj/structure/table/wood/fancy/black,
/obj/item/storage/toolbox/mechanical,
/obj/item/stock_parts/power_store/battery/super,
/obj/item/flatpacked_machine/wind_turbine,
/turf/open/floor/plastic,
/area/template_noop)
"H" = (
/obj/machinery/power/manufacturing/crafter,
/turf/open/floor/plastic,
/area/template_noop)
"O" = (
/obj/structure/inflatable/door,
/turf/open/floor/plastic,
/area/template_noop)
"Q" = (
/obj/machinery/power/manufacturing/sorter,
/turf/open/floor/plastic,
/area/template_noop)
"Z" = (
/obj/machinery/autolathe,
/obj/item/stack/sheet/rglass/fifty,
/turf/open/floor/plastic,
/area/template_noop)

(1,1,1) = {"
C
C
C
C
C
C
C
C
C
C
C
"}
(2,1,1) = {"
C
a
a
a
a
a
a
a
a
a
C
"}
(3,1,1) = {"
C
a
a
v
w
Z
E
p
a
a
C
"}
(4,1,1) = {"
C
a
a
f
f
Q
y
H
a
a
C
"}
(5,1,1) = {"
C
a
a
f
f
s
g
a
a
a
C
"}
(6,1,1) = {"
C
a
a
A
A
Q
y
H
a
a
O
"}
(7,1,1) = {"
C
a
a
f
f
s
i
a
a
a
C
"}
(8,1,1) = {"
C
a
a
f
f
Q
y
j
a
a
C
"}
(9,1,1) = {"
C
a
a
y
y
Q
y
m
a
a
C
"}
(10,1,1) = {"
C
a
a
a
a
a
a
a
a
a
C
"}
(11,1,1) = {"
C
C
C
C
C
C
C
C
C
C
C
"}
