//MAP CONVERTED BY dmm2tgm.py THIS HEADER COMMENT PREVENTS RECONVERSION, DO NOT REMOVE
"a" = (
/obj/machinery/atmospherics/pipe/smart/manifold4w/supply/hidden/layer4,
/obj/machinery/atmospherics/pipe/smart/manifold4w/scrubbers/hidden/layer2,
/turf/open/floor/wood,
/area/template_noop)
"b" = (
/obj/effect/turf_decal/weather/snow/corner{
	dir = 5
	},
/obj/machinery/atmospherics/components/unary/vent_scrubber/on/layer2,
/turf/open/floor/wood,
/area/template_noop)
"g" = (
/obj/item/toy/plush/lizard_plushie/greyscale{
	pixel_x = 8;
	pixel_y = -4;
	name = "Secret-Chiller"
	},
/obj/item/toy/snowball{
	pixel_y = -11
	},
/obj/item/toy/snowball{
	pixel_y = -13;
	pixel_x = 9
	},
/turf/open/misc/asteroid/snow/standard_air,
/area/template_noop)
"k" = (
/obj/structure/closet/crate/wooden,
/obj/item/stack/sheet/mineral/wood/thirty,
/obj/item/lighter,
/turf/open/floor/wood,
/area/template_noop)
"n" = (
/obj/machinery/light/directional/west,
/turf/open/misc/asteroid/snow/standard_air,
/area/template_noop)
"o" = (
/obj/machinery/light/directional/east,
/obj/structure/flora/rock/pile/icy/style_random,
/turf/open/misc/asteroid/snow/standard_air,
/area/template_noop)
"u" = (
/obj/item/spear/grey_tide,
/turf/open/misc/asteroid/snow/standard_air,
/area/template_noop)
"w" = (
/obj/structure/flora/rock/pile/icy/style_3,
/obj/modular_map_connector,
/turf/open/misc/asteroid/snow/standard_air,
/area/template_noop)
"z" = (
/obj/effect/turf_decal/weather/snow/corner{
	dir = 1
	},
/obj/machinery/atmospherics/components/unary/vent_pump/on/layer4{
	dir = 8
	},
/turf/open/floor/wood,
/area/template_noop)
"C" = (
/obj/structure/flora/grass/green/style_random,
/turf/open/misc/asteroid/snow/standard_air,
/area/template_noop)
"E" = (
/obj/structure/bonfire,
/turf/open/misc/asteroid/snow/standard_air,
/area/template_noop)
"J" = (
/turf/template_noop,
/area/template_noop)
"L" = (
/mob/living/basic/cockroach,
/turf/open/misc/asteroid/snow/standard_air,
/area/template_noop)
"N" = (
/turf/open/misc/asteroid/snow/standard_air,
/area/template_noop)
"O" = (
/obj/structure/flora/rock/icy/style_2,
/turf/open/misc/asteroid/snow/standard_air,
/area/template_noop)

(1,1,1) = {"
L
E
N
w
n
b
a
"}
(2,1,1) = {"
o
g
u
C
O
N
z
"}
(3,1,1) = {"
J
J
J
J
J
J
k
"}
