//MAP CONVERTED BY dmm2tgm.py THIS HEADER COMMENT PREVENTS RECONVERSION, DO NOT REMOVE
"a" = (
/turf/closed/mineral/random/jungle,
/area/template_noop)
"c" = (
/mob/living/basic/bat/away_caves,
/turf/open/misc/dirt/station,
/area/template_noop)
"d" = (
/obj/effect/decal/remains/human,
/turf/open/misc/dirt/station,
/area/template_noop)
"e" = (
/obj/structure/closet/crate,
/obj/effect/decal/cleanable/cobweb/cobweb2,
/obj/item/stack/ore/iron{
	amount = 6
	},
/obj/item/stack/ore/glass/basalt{
	amount = 8
	},
/obj/item/stack/sheet/mineral/coal,
/turf/open/floor/grass,
/area/template_noop)
"m" = (
/turf/open/misc/dirt/station,
/area/template_noop)
"r" = (
/obj/structure/wall_torch/directional/west,
/obj/structure/flora/rock/pile/jungle/style_4,
/obj/modular_map_connector,
/turf/open/misc/dirt/station,
/area/template_noop)
"K" = (
/obj/structure/barricade/wooden/crude,
/turf/open/misc/dirt/station,
/area/template_noop)
"N" = (
/turf/template_noop,
/area/template_noop)
"Q" = (
/obj/effect/turf_decal/weather/dirt{
	dir = 1
	},
/obj/machinery/atmospherics/pipe/smart/manifold4w/supply/hidden/layer4,
/obj/machinery/atmospherics/components/unary/vent_scrubber/on/layer2,
/turf/open/floor/grass,
/area/template_noop)
"T" = (
/obj/machinery/atmospherics/components/unary/vent_pump/on/layer4{
	dir = 8
	},
/turf/open/floor/grass,
/area/template_noop)
"X" = (
/obj/structure/wall_torch/directional/east,
/obj/structure/flora/rock/pile/jungle/style_5,
/obj/item/spear/bonespear,
/turf/open/misc/dirt/station,
/area/template_noop)
"Z" = (
/obj/effect/turf_decal/weather/dirt{
	dir = 9
	},
/obj/structure/flora/grass/jungle,
/turf/open/floor/grass,
/area/template_noop)

(1,1,1) = {"
m
a
a
r
K
m
Q
"}
(2,1,1) = {"
c
X
d
m
a
Z
T
"}
(3,1,1) = {"
N
N
N
N
N
N
e
"}
