//MAP CONVERTED BY dmm2tgm.py THIS HEADER COMMENT PREVENTS RECONVERSION, DO NOT REMOVE
"a" = (
/obj/structure/barricade/wooden,
/turf/open/floor/plating,
/area/template_noop)
"g" = (
/obj/effect/decal/cleanable/cobweb,
/obj/machinery/smartfridge/drying/rack,
/turf/open/floor/plating,
/area/template_noop)
"o" = (
/turf/template_noop,
/area/template_noop)
"p" = (
/obj/effect/decal/cleanable/dirt,
/obj/effect/decal/cleanable/ash,
/turf/open/floor/plating,
/area/template_noop)
"r" = (
/obj/machinery/light/small/directional/west,
/obj/effect/spawner/random/entertainment/drugs,
/obj/machinery/atmospherics/components/unary/vent_scrubber/on/layer2,
/turf/open/floor/plating,
/area/template_noop)
"s" = (
/obj/effect/spawner/random/maintenance/three,
/obj/machinery/atmospherics/pipe/smart/manifold4w/scrubbers/hidden/layer2,
/turf/open/floor/plating,
/area/template_noop)
"t" = (
/obj/item/shovel/spade,
/obj/effect/decal/cleanable/ash,
/obj/machinery/atmospherics/pipe/smart/manifold4w/scrubbers/hidden/layer2,
/turf/open/floor/plating,
/area/template_noop)
"y" = (
/obj/effect/spawner/random/maintenance/two,
/obj/machinery/atmospherics/components/unary/vent_pump/on/layer4{
	dir = 8
	},
/turf/open/floor/plating,
/area/template_noop)
"D" = (
/obj/effect/spawner/random/medical/memeorgans,
/obj/structure/closet/crate/freezer,
/turf/open/floor/plating,
/area/template_noop)
"J" = (
/obj/effect/decal/cleanable/cobweb/cobweb2,
/obj/item/food/grown/cannabis,
/obj/structure/closet/crate,
/obj/effect/spawner/random/entertainment/drugs,
/obj/effect/spawner/random/entertainment/drugs,
/turf/open/floor/plating,
/area/template_noop)
"K" = (
/obj/machinery/light/small/directional/east,
/obj/effect/mapping_helpers/broken_floor,
/turf/open/floor/plating,
/area/template_noop)
"N" = (
/obj/structure/barricade/wooden/crude,
/obj/machinery/atmospherics/pipe/smart/manifold4w/scrubbers/hidden/layer2,
/turf/open/floor/plating,
/area/template_noop)
"R" = (
/obj/effect/mapping_helpers/broken_floor,
/obj/machinery/atmospherics/pipe/smart/manifold4w/supply/hidden/layer4,
/obj/machinery/atmospherics/pipe/smart/manifold4w/scrubbers/hidden/layer2,
/turf/open/floor/plating,
/area/template_noop)
"X" = (
/obj/structure/closet/crate/wooden,
/obj/item/food/grown/cannabis,
/obj/item/food/grown/cannabis,
/obj/effect/spawner/random/entertainment/drugs,
/obj/effect/spawner/random/entertainment/drugs,
/turf/open/floor/plating,
/area/template_noop)
"Y" = (
/obj/machinery/hydroponics/constructable,
/turf/open/floor/plating,
/area/template_noop)
"Z" = (
/obj/effect/decal/remains/human,
/obj/effect/decal/cleanable/dirt,
/obj/modular_map_connector,
/obj/machinery/atmospherics/pipe/smart/manifold4w/scrubbers/hidden/layer2,
/turf/open/floor/plating,
/area/template_noop)

(1,1,1) = {"
g
r
s
Z
t
N
R
"}
(2,1,1) = {"
Y
p
D
X
K
a
y
"}
(3,1,1) = {"
o
o
o
o
o
o
J
"}
