//MAP CONVERTED BY dmm2tgm.py THIS HEADER COMMENT PREVENTS RECONVERSION, DO NOT REMOVE
"a" = (
/obj/structure/cable,
/obj/machinery/power/solar,
/turf/open/floor/iron/solarpanel/airless,
/area/solars/tarkon)
"c" = (
/obj/structure/lattice/catwalk,
/turf/open/space/basic,
/area/solars/tarkon)
"d" = (
/obj/structure/lattice/catwalk,
/turf/open/space,
/area/solars/tarkon)
"e" = (
/obj/structure/cable,
/obj/modular_map_connector,
/turf/open/floor/iron/solarpanel/airless,
/area/solars/tarkon)
"f" = (
/obj/structure/cable,
/turf/open/floor/iron/solarpanel/airless,
/area/solars/tarkon)
"g" = (
/obj/machinery/power/tracker,
/obj/structure/cable,
/turf/open/floor/iron/solarpanel/airless,
/area/solars/tarkon)
"h" = (
/obj/structure/lattice,
/mob/living/basic/carp,
/turf/open/space/basic,
/area/solars/tarkon)
"i" = (
/obj/structure/lattice/catwalk,
/obj/structure/cable,
/turf/open/space,
/area/solars/tarkon)
"j" = (
/obj/structure/lattice/catwalk,
/obj/structure/cable,
/mob/living/basic/carp,
/turf/open/space/basic,
/area/solars/tarkon)
"t" = (
/turf/template_noop,
/area/template_noop)
"w" = (
/obj/item/solar_assembly,
/obj/structure/cable,
/turf/open/floor/iron/solarpanel/airless,
/area/solars/tarkon)
"C" = (
/obj/structure/lattice,
/obj/item/stack/cable_coil/thirty,
/turf/open/space/basic,
/area/solars/tarkon)
"F" = (
/obj/structure/lattice,
/turf/open/space/basic,
/area/solars/tarkon)
"L" = (
/obj/structure/lattice/catwalk,
/obj/structure/cable,
/turf/open/space/basic,
/area/solars/tarkon)
"R" = (
/obj/structure/lattice/catwalk,
/obj/structure/cable,
/obj/item/stack/cable_coil/five,
/turf/open/space/basic,
/area/solars/tarkon)
"T" = (
/obj/structure/lattice,
/turf/open/space,
/area/solars/tarkon)
"W" = (
/obj/structure/lattice/catwalk,
/obj/item/stack/cable_coil/five,
/turf/open/space/basic,
/area/solars/tarkon)

(1,1,1) = {"
t
t
t
t
t
t
t
t
t
e
t
t
t
t
t
t
t
t
t
"}
(2,1,1) = {"
t
t
t
t
a
t
t
t
f
c
a
t
t
t
a
t
t
t
t
"}
(3,1,1) = {"
t
t
t
a
L
a
F
F
f
W
a
F
F
a
c
f
t
t
t
"}
(4,1,1) = {"
t
t
t
a
L
a
t
t
f
L
a
t
t
a
L
f
t
t
t
"}
(5,1,1) = {"
t
a
a
a
L
a
a
F
f
L
a
F
a
a
c
f
f
f
t
"}
(6,1,1) = {"
a
L
j
c
W
c
c
c
c
L
L
c
L
c
c
c
L
L
f
"}
(7,1,1) = {"
t
a
a
a
c
a
a
a
F
c
F
f
f
f
c
a
a
a
t
"}
(8,1,1) = {"
t
F
t
a
d
w
t
t
F
c
F
t
t
f
d
a
t
F
t
"}
(9,1,1) = {"
t
F
t
T
d
F
a
a
a
c
f
f
f
T
d
T
t
C
t
"}
(10,1,1) = {"
g
L
L
L
c
c
c
W
c
L
L
c
c
L
L
L
c
L
L
"}
(11,1,1) = {"
t
F
t
T
d
T
f
f
f
c
a
a
a
T
i
T
t
F
t
"}
(12,1,1) = {"
t
F
t
w
d
w
t
t
F
c
F
t
t
f
d
f
t
F
t
"}
(13,1,1) = {"
t
w
w
w
c
w
w
w
F
c
F
f
f
f
c
f
f
f
t
"}
(14,1,1) = {"
w
c
L
L
L
W
c
c
c
L
c
c
L
L
c
L
L
c
f
"}
(15,1,1) = {"
t
w
w
w
L
w
w
F
a
R
a
F
f
f
c
f
f
f
t
"}
(16,1,1) = {"
t
t
t
w
L
w
t
t
a
L
a
t
t
f
L
f
t
t
t
"}
(17,1,1) = {"
t
t
t
w
c
w
F
F
a
L
a
F
h
f
L
f
t
t
t
"}
(18,1,1) = {"
t
t
t
t
w
t
t
t
a
c
a
t
t
t
f
t
t
t
t
"}
(19,1,1) = {"
t
t
t
t
t
t
t
t
t
a
t
t
t
t
t
t
t
t
t
"}
