//MAP CONVERTED BY dmm2tgm.py THIS HEADER COMMENT PREVENTS RECONVERSION, DO NOT REMOVE
"a" = (
/obj/structure/lattice/catwalk,
/turf/open/space/basic,
/area/solars/tarkon)
"d" = (
/obj/structure/lattice,
/turf/open/space,
/area/solars/tarkon)
"i" = (
/obj/machinery/power/tracker,
/obj/structure/cable,
/turf/open/floor/iron/solarpanel/airless,
/area/solars/tarkon)
"j" = (
/obj/structure/lattice/catwalk,
/obj/structure/cable,
/turf/open/space,
/area/solars/tarkon)
"l" = (
/obj/structure/lattice/catwalk,
/obj/structure/cable,
/turf/open/space/basic,
/area/solars/tarkon)
"v" = (
/obj/structure/lattice/catwalk,
/mob/living/basic/carp,
/turf/open/space/basic,
/area/solars/tarkon)
"w" = (
/obj/structure/cable,
/obj/machinery/power/solar,
/turf/open/floor/iron/solarpanel/airless,
/area/solars/tarkon)
"A" = (
/obj/structure/cable,
/mob/living/basic/carp,
/turf/open/floor/iron/solarpanel/airless,
/area/solars/tarkon)
"B" = (
/obj/structure/lattice,
/mob/living/basic/carp,
/turf/open/space/basic,
/area/solars/tarkon)
"E" = (
/obj/structure/lattice,
/turf/open/space/basic,
/area/solars/tarkon)
"L" = (
/obj/structure/lattice/catwalk,
/obj/effect/mob_spawn/corpse/human/engineer/mod,
/turf/open/space/basic,
/area/solars/tarkon)
"M" = (
/obj/structure/cable,
/turf/open/floor/iron/solarpanel/airless,
/area/solars/tarkon)
"N" = (
/obj/structure/lattice,
/obj/item/stack/cable_coil/thirty,
/turf/open/space/basic,
/area/solars/tarkon)
"Q" = (
/obj/structure/lattice/catwalk,
/turf/open/space,
/area/solars/tarkon)
"S" = (
/obj/structure/lattice/catwalk,
/obj/structure/cable,
/mob/living/basic/carp,
/turf/open/space/basic,
/area/solars/tarkon)
"X" = (
/turf/template_noop,
/area/template_noop)
"Y" = (
/obj/structure/cable,
/obj/machinery/power/solar,
/obj/modular_map_connector,
/turf/open/floor/iron/solarpanel/airless,
/area/solars/tarkon)

(1,1,1) = {"
X
X
X
X
X
X
X
X
X
Y
X
X
X
X
X
X
X
X
X
"}
(2,1,1) = {"
X
X
X
X
A
X
X
X
w
l
w
X
X
X
w
X
X
X
X
"}
(3,1,1) = {"
X
X
X
w
l
M
E
E
w
a
w
B
E
w
l
M
X
X
X
"}
(4,1,1) = {"
X
X
X
w
l
M
X
X
w
a
w
X
X
w
a
M
X
X
X
"}
(5,1,1) = {"
X
M
M
M
l
M
M
E
w
a
w
E
w
w
a
M
M
M
X
"}
(6,1,1) = {"
w
l
l
a
l
a
a
l
l
l
l
l
l
l
a
a
a
l
w
"}
(7,1,1) = {"
X
M
M
M
l
M
M
M
E
a
E
M
M
M
a
w
w
w
X
"}
(8,1,1) = {"
X
E
X
w
Q
w
X
X
B
L
N
X
X
M
j
w
X
E
X
"}
(9,1,1) = {"
X
E
X
d
Q
E
w
w
w
l
M
M
M
d
j
d
X
E
X
"}
(10,1,1) = {"
i
l
l
l
l
l
l
a
a
a
a
a
a
a
l
l
l
l
l
"}
(11,1,1) = {"
X
E
X
d
Q
d
w
w
w
l
M
M
M
d
j
d
X
E
X
"}
(12,1,1) = {"
X
E
X
w
Q
w
X
X
E
l
E
X
X
w
j
M
X
E
X
"}
(13,1,1) = {"
X
w
w
w
a
w
w
w
E
l
E
w
w
w
l
M
M
M
X
"}
(14,1,1) = {"
w
v
l
l
l
a
l
l
l
l
l
l
l
l
l
S
l
l
w
"}
(15,1,1) = {"
X
w
w
w
l
w
w
E
M
l
M
E
w
w
a
w
w
w
X
"}
(16,1,1) = {"
X
X
X
w
l
w
X
X
M
l
M
X
X
w
a
w
X
X
X
"}
(17,1,1) = {"
X
X
X
w
l
w
B
E
M
l
M
E
E
w
l
w
X
X
X
"}
(18,1,1) = {"
X
X
X
X
w
X
X
X
M
a
M
X
X
X
w
X
X
X
X
"}
(19,1,1) = {"
X
X
X
X
X
X
X
X
X
M
X
X
X
X
X
X
X
X
X
"}
