//MAP CONVERTED BY dmm2tgm.py THIS HEADER COMMENT PREVENTS RECONVERSION, DO NOT REMOVE
"bo" = (
/obj/structure/lattice/catwalk,
/obj/structure/shuttle_decoration/eva_catwalks/directional/north,
/obj/structure/railing/eva_handhold/directional/north,
/turf/template_noop,
/area/shuttle/salvaged_shuttle)
"bv" = (
/obj/structure/shuttle_decoration/console/directional/north,
/turf/closed/wall/mineral/nanocarbon/nodiagonal/primary_colour,
/area/shuttle/salvaged_shuttle)
"ce" = (
/obj/machinery/power/shuttle_engine/heater/salvage{
	dir = 4
	},
/obj/structure/engine_covers/heater_cover{
	dir = 8
	},
/turf/open/floor/plating/nanocarbon,
/area/shuttle/salvaged_shuttle)
"cC" = (
/obj/structure/shuttle_decoration/wall_plate/silver_foil{
	dir = 1
	},
/obj/structure/shuttle_decoration/extinguisher/directional/south,
/turf/closed/wall/mineral/nanocarbon/nodiagonal/primary_colour,
/area/shuttle/salvaged_shuttle)
"cP" = (
/obj/machinery/power/shuttle_engine/propulsion/salvage{
	dir = 4
	},
/obj/structure/engine_covers/thruster_nozzle{
	dir = 4
	},
/turf/open/floor/plating/nanocarbon,
/area/shuttle/salvaged_shuttle)
"dD" = (
/obj/structure/railing/eva_handhold/directional/south,
/obj/structure/railing/eva_handhold/directional/north,
/obj/effect/mapping_helpers/salvage_anchor/five,
/obj/structure/marker_beacon/jade,
/turf/open/floor/engine/anchor_jack,
/area/shuttle/salvaged_shuttle)
"ez" = (
/obj/effect/spawner/random/salvage/every_small_tank,
/turf/open/floor/iron/colony/nanocarbon,
/area/shuttle/salvaged_shuttle)
"eB" = (
/obj/structure/shuttle_decoration/wall_plate/silver_foil{
	dir = 1
	},
/turf/closed/wall/mineral/nanocarbon/nodiagonal/secondary_colour,
/area/shuttle/salvaged_shuttle)
"fe" = (
/obj/structure/shuttle_decoration/console/directional/south,
/obj/machinery/exoscanner/shuttle_part/open_sensors_blister/directional/north,
/turf/closed/wall/mineral/nanocarbon/nodiagonal/primary_colour,
/area/shuttle/salvaged_shuttle)
"fI" = (
/obj/structure/lattice,
/obj/structure/titanium_structure,
/obj/structure/shuttle_decoration/wall_plate/nanocarbon/primary_colour,
/obj/structure/shuttle_decoration/eva_catwalks/directional/south,
/obj/structure/railing/eva_handhold/directional/south,
/turf/template_noop,
/area/shuttle/salvaged_shuttle)
"gM" = (
/obj/structure/lattice/catwalk,
/obj/structure/shuttle_decoration/wall_plate/armor{
	dir = 10
	},
/obj/structure/shuttle_decoration/eva_catwalks/directional/south,
/turf/template_noop,
/area/shuttle/salvaged_shuttle)
"gX" = (
/obj/machinery/light/red/directional/south,
/turf/open/floor/plating/nanocarbon,
/area/shuttle/salvaged_shuttle)
"hx" = (
/obj/structure/shuttle_decoration/radiator/directional/north,
/turf/closed/wall/mineral/nanocarbon/nodiagonal/primary_colour,
/area/shuttle/salvaged_shuttle)
"ik" = (
/obj/structure/shuttle_decoration/wall_plate/silver_foil,
/obj/effect/mapping_helpers/salvage_anchor/end/seven,
/turf/closed/wall/mineral/nanocarbon/nodiagonal/secondary_colour,
/area/shuttle/salvaged_shuttle)
"iy" = (
/obj/machinery/light/red/directional/east,
/turf/open/floor/plating/nanocarbon,
/area/shuttle/salvaged_shuttle)
"iz" = (
/obj/structure/shuttle_decoration/wall_plate/silver_foil{
	dir = 1
	},
/turf/closed/wall/mineral/nanocarbon/nodiagonal/primary_colour,
/area/shuttle/salvaged_shuttle)
"iA" = (
/obj/structure/shuttle_decoration/wall_plate/silver_foil{
	dir = 1
	},
/obj/structure/shuttle_decoration/wall_plate/nanocarbon/primary_colour,
/turf/closed/wall/mineral/nanocarbon/nodiagonal/primary_colour,
/area/shuttle/salvaged_shuttle)
"jv" = (
/obj/structure/shuttle_decoration/wall_plate/silver_foil,
/obj/structure/shuttle_decoration/rcs/directional/north,
/turf/closed/wall/mineral/nanocarbon/nodiagonal/secondary_colour,
/area/shuttle/salvaged_shuttle)
"jX" = (
/obj/structure/titanium_structure,
/obj/structure/shuttle_decoration/wall_plate/armor,
/obj/structure/shuttle_decoration/eva_catwalks/directional/south,
/obj/structure/railing/eva_handhold/directional/south,
/turf/open/floor/plating/nanocarbon/exterior/black,
/area/shuttle/salvaged_shuttle)
"km" = (
/obj/structure/shuttle_decoration/ladder/directional/north,
/turf/closed/wall/mineral/nanocarbon/nodiagonal/primary_colour,
/area/shuttle/salvaged_shuttle)
"kO" = (
/turf/open/floor/catwalk_floor/colony_fabricator/nanocarbon,
/area/shuttle/salvaged_shuttle)
"kP" = (
/obj/effect/spawner/random/salvage/interior_trash_n_debris,
/turf/open/floor/iron/colony/nanocarbon,
/area/shuttle/salvaged_shuttle)
"kZ" = (
/obj/structure/shuttle_decoration/wall_plate/armor,
/obj/structure/shuttle_decoration/wall_plate/armor{
	dir = 1
	},
/turf/closed/wall/mineral/aluminum,
/area/shuttle/salvaged_shuttle)
"ly" = (
/obj/structure/shuttle_decoration/wall_plate/silver_foil,
/obj/structure/shuttle_decoration/rcs/directional/north,
/turf/closed/wall/mineral/nanocarbon/nodiagonal/primary_colour,
/area/shuttle/salvaged_shuttle)
"lO" = (
/obj/effect/spawner/random/salvage/crate_only/salvage,
/obj/machinery/light/red/directional/east,
/turf/open/floor/iron/colony/nanocarbon,
/area/shuttle/salvaged_shuttle)
"md" = (
/obj/structure/lattice,
/obj/structure/shuttle_decoration/wall_plate/nanocarbon/diagonal/primary_colour{
	dir = 1
	},
/turf/template_noop,
/area/shuttle/salvaged_shuttle)
"mj" = (
/obj/structure/lattice,
/obj/structure/shuttle_decoration/wall_plate/nanocarbon/primary_colour{
	dir = 1
	},
/obj/structure/shuttle_decoration/eva_catwalks/directional/north,
/turf/template_noop,
/area/shuttle/salvaged_shuttle)
"nk" = (
/turf/open/floor/iron/colony/texture/nanocarbon,
/area/shuttle/salvaged_shuttle)
"nN" = (
/obj/structure/shuttle_decoration/extinguisher/directional/east,
/turf/closed/wall/mineral/aluminum,
/area/shuttle/salvaged_shuttle)
"nP" = (
/obj/structure/chair/comfy/shuttle{
	dir = 1;
	pixel_y = -5
	},
/obj/effect/spawner/random/salvage/interior_trash_n_debris,
/turf/open/floor/iron/colony/nanocarbon,
/area/shuttle/salvaged_shuttle)
"oM" = (
/obj/machinery/exoscanner/shuttle_part/radar_panel/directional/south,
/turf/closed/wall/mineral/nanocarbon/nodiagonal/secondary_colour,
/area/shuttle/salvaged_shuttle)
"pa" = (
/obj/structure/shuttle_decoration/ladder/directional/south,
/turf/closed/wall/mineral/nanocarbon/nodiagonal/primary_colour,
/area/shuttle/salvaged_shuttle)
"pH" = (
/obj/structure/shuttle_decoration/eva_catwalks/directional/east,
/obj/machinery/exoscanner/shuttle_part/radar_panel/directional/east,
/turf/closed/wall/mineral/nanocarbon/nodiagonal/primary_colour,
/area/shuttle/salvaged_shuttle)
"qp" = (
/obj/structure/shuttle_decoration/wall_plate/silver_foil{
	dir = 1
	},
/obj/structure/shuttle_decoration/wall_plate/silver_foil{
	dir = 1
	},
/turf/closed/wall/mineral/nanocarbon/nodiagonal/secondary_colour,
/area/shuttle/salvaged_shuttle)
"qY" = (
/obj/effect/mapping_helpers/salvage_anchor/end/three,
/turf/closed/wall/mineral/nanocarbon/nodiagonal/primary_colour,
/area/shuttle/salvaged_shuttle)
"rb" = (
/turf/open/floor/plating/aluminum,
/area/shuttle/salvaged_shuttle)
"rL" = (
/obj/structure/shuttle_decoration/wall_plate/silver_foil,
/turf/closed/wall/mineral/nanocarbon/nodiagonal/secondary_colour,
/area/shuttle/salvaged_shuttle)
"sj" = (
/obj/structure/chair/comfy/shuttle{
	dir = 4
	},
/obj/machinery/light/red/directional/south,
/turf/open/floor/plating/nanocarbon/exterior/standard,
/area/shuttle/salvaged_shuttle)
"sl" = (
/obj/structure/shuttle_decoration/wall_plate/plastamic{
	dir = 8
	},
/turf/closed/wall/mineral/aluminum,
/area/shuttle/salvaged_shuttle)
"tC" = (
/obj/effect/spawner/random/salvage/interior_trash_n_debris,
/turf/open/floor/plating/nanocarbon,
/area/shuttle/salvaged_shuttle)
"uk" = (
/obj/structure/railing/eva_handhold/directional/south,
/obj/structure/railing/eva_handhold/directional/north,
/obj/effect/mapping_helpers/salvage_anchor/seven,
/obj/structure/marker_beacon/jade,
/turf/open/floor/engine/anchor_jack,
/area/shuttle/salvaged_shuttle)
"uK" = (
/obj/structure/shuttle_decoration/liquid_tank/battery,
/obj/structure/shuttle_decoration/wall_plate/plastamic,
/obj/machinery/light/red/directional/north,
/turf/open/floor/plating/nanocarbon,
/area/shuttle/salvaged_shuttle)
"uL" = (
/obj/structure/shuttle_decoration/wall_plate/silver_foil{
	dir = 1
	},
/obj/structure/shuttle_decoration/rcs/directional/south,
/turf/closed/wall/mineral/nanocarbon/nodiagonal/secondary_colour,
/area/shuttle/salvaged_shuttle)
"vn" = (
/obj/machinery/light/red/directional/east,
/turf/open/floor/catwalk_floor/colony_fabricator/nanocarbon,
/area/shuttle/salvaged_shuttle)
"vE" = (
/obj/structure/railing/eva_handhold/directional/south,
/obj/structure/railing/eva_handhold/directional/north,
/obj/effect/mapping_helpers/salvage_anchor/two,
/obj/structure/marker_beacon/jade,
/turf/open/floor/engine/anchor_jack,
/area/shuttle/salvaged_shuttle)
"wC" = (
/obj/structure/lattice,
/obj/structure/shuttle_decoration/wall_plate/nanocarbon/diagonal/primary_colour{
	dir = 9
	},
/turf/template_noop,
/area/shuttle/salvaged_shuttle)
"wJ" = (
/obj/structure/shuttle_decoration/bullbar/directional/east,
/obj/structure/shuttle_decoration/eva_catwalks/directional/east,
/turf/closed/wall/mineral/nanocarbon/nodiagonal/primary_colour,
/area/shuttle/salvaged_shuttle)
"xs" = (
/obj/structure/shuttle_decoration/wall_plate/silver_foil{
	dir = 1
	},
/obj/structure/shuttle_decoration/rcs/directional/south,
/turf/closed/wall/mineral/nanocarbon/nodiagonal/primary_colour,
/area/shuttle/salvaged_shuttle)
"xx" = (
/obj/machinery/power/shuttle_engine/propulsion/salvage{
	dir = 8
	},
/obj/structure/engine_covers/thruster_nozzle{
	dir = 8
	},
/turf/open/floor/plating/nanocarbon,
/area/shuttle/salvaged_shuttle)
"yi" = (
/turf/open/floor/plating/nanocarbon,
/area/shuttle/salvaged_shuttle)
"ym" = (
/obj/structure/chair/comfy/shuttle{
	pixel_y = 12
	},
/turf/open/floor/iron/colony/nanocarbon,
/area/shuttle/salvaged_shuttle)
"yu" = (
/turf/closed/wall/mineral/nanocarbon/nodiagonal/primary_colour,
/area/shuttle/salvaged_shuttle)
"yx" = (
/obj/structure/shuttle_decoration/eva_catwalks/directional/east,
/obj/structure/shuttle_decoration/bullbar/directional/east,
/turf/closed/wall/mineral/nanocarbon/nodiagonal/primary_colour,
/area/shuttle/salvaged_shuttle)
"zd" = (
/obj/structure/chair/comfy/shuttle{
	dir = 1;
	pixel_y = -5
	},
/turf/open/floor/iron/colony/nanocarbon,
/area/shuttle/salvaged_shuttle)
"zl" = (
/obj/structure/lattice,
/obj/structure/titanium_structure,
/obj/structure/shuttle_decoration/wall_plate/nanocarbon/diagonal/primary_colour{
	dir = 1
	},
/turf/template_noop,
/area/shuttle/salvaged_shuttle)
"zm" = (
/obj/effect/spawner/random/salvage/container_or_crate_or_cargo/salvage,
/turf/open/floor/plating/aluminum,
/area/shuttle/salvaged_shuttle)
"Aj" = (
/obj/machinery/computer/old{
	dir = 8
	},
/obj/machinery/light/red/directional/south,
/turf/open/floor/iron/colony/nanocarbon,
/area/shuttle/salvaged_shuttle)
"Aq" = (
/obj/structure/shuttle_decoration/wall_plate/plastamic{
	dir = 4
	},
/turf/closed/wall/mineral/aluminum,
/area/shuttle/salvaged_shuttle)
"Av" = (
/obj/machinery/exoscanner/shuttle_part/radio_dish/directional/east,
/turf/closed/wall/mineral/nanocarbon/nodiagonal/black,
/area/shuttle/salvaged_shuttle)
"AC" = (
/obj/machinery/exoscanner/shuttle_part/radar_panel/directional/north,
/turf/closed/wall/mineral/nanocarbon/nodiagonal/secondary_colour,
/area/shuttle/salvaged_shuttle)
"Bw" = (
/obj/effect/mapping_helpers/salvage_anchor/end/six,
/turf/closed/wall/mineral/nanocarbon/nodiagonal/primary_colour,
/area/shuttle/salvaged_shuttle)
"BC" = (
/obj/structure/shuttle_decoration/headlight/directional/west,
/turf/closed/wall/mineral/aluminum,
/area/shuttle/salvaged_shuttle)
"BV" = (
/turf/open/floor/plating/nanocarbon/exterior/black,
/area/shuttle/salvaged_shuttle)
"BW" = (
/obj/structure/lattice/catwalk,
/obj/structure/shuttle_decoration/wall_plate/armor{
	dir = 9
	},
/obj/structure/shuttle_decoration/eva_catwalks/directional/north,
/turf/template_noop,
/area/shuttle/salvaged_shuttle)
"CC" = (
/turf/open/floor/iron/colony/nanocarbon,
/area/shuttle/salvaged_shuttle)
"CU" = (
/turf/closed/wall/mineral/nanocarbon/nodiagonal/black,
/area/shuttle/salvaged_shuttle)
"Dm" = (
/obj/structure/railing/eva_handhold/directional/south,
/obj/structure/railing/eva_handhold/directional/north,
/obj/effect/mapping_helpers/salvage_anchor/six,
/obj/structure/marker_beacon/jade,
/turf/open/floor/engine/anchor_jack,
/area/shuttle/salvaged_shuttle)
"Dp" = (
/obj/structure/chair/comfy/shuttle{
	dir = 4
	},
/turf/open/floor/iron/colony/nanocarbon,
/area/shuttle/salvaged_shuttle)
"Du" = (
/obj/structure/shuttle_decoration/wall_plate/silver_foil,
/obj/structure/shuttle_decoration/wall_plate/nanocarbon/primary_colour{
	dir = 1
	},
/turf/closed/wall/mineral/nanocarbon/nodiagonal/primary_colour,
/area/shuttle/salvaged_shuttle)
"Dx" = (
/obj/structure/window/fulltile/salvage_shuttle,
/turf/open/floor/plating/nanocarbon,
/area/shuttle/salvaged_shuttle)
"Em" = (
/obj/structure/railing/eva_handhold/directional/south,
/obj/structure/railing/eva_handhold/directional/north,
/obj/effect/mapping_helpers/salvage_anchor/three,
/obj/structure/marker_beacon/jade,
/turf/open/floor/engine/anchor_jack,
/area/shuttle/salvaged_shuttle)
"Ev" = (
/obj/structure/railing/eva_handhold/directional/south,
/obj/structure/railing/eva_handhold/directional/north,
/obj/effect/mapping_helpers/salvage_anchor/four,
/obj/structure/marker_beacon/jade,
/turf/open/floor/engine/anchor_jack,
/area/shuttle/salvaged_shuttle)
"Ew" = (
/turf/open/floor/plating/nanocarbon/exterior/standard,
/area/shuttle/salvaged_shuttle)
"Ex" = (
/obj/structure/lattice,
/obj/structure/shuttle_decoration/wall_plate/nanocarbon/diagonal/primary_colour,
/turf/template_noop,
/area/shuttle/salvaged_shuttle)
"EQ" = (
/obj/structure/lattice,
/obj/structure/shuttle_decoration/wall_plate/nanocarbon/diagonal/primary_colour{
	dir = 10
	},
/turf/template_noop,
/area/shuttle/salvaged_shuttle)
"Fg" = (
/obj/structure/shuttle_decoration/console/directional/south,
/turf/closed/wall/mineral/nanocarbon/nodiagonal/primary_colour,
/area/shuttle/salvaged_shuttle)
"Fz" = (
/obj/effect/spawner/random/salvage/interior_trash_n_debris,
/turf/open/floor/iron/colony/texture/nanocarbon,
/area/shuttle/salvaged_shuttle)
"Gu" = (
/obj/structure/lattice/catwalk,
/obj/effect/spawner/random/salvage/interior_trash_n_debris,
/obj/structure/shuttle_decoration/eva_catwalks/directional/south,
/obj/structure/railing/eva_handhold/directional/south,
/turf/template_noop,
/area/shuttle/salvaged_shuttle)
"Gy" = (
/obj/structure/shuttle_decoration/liquid_tank/reactor,
/turf/open/floor/plating/nanocarbon,
/area/shuttle/salvaged_shuttle)
"HG" = (
/obj/effect/spawner/random/salvage/interior_trash_n_debris,
/turf/open/floor/plating/aluminum,
/area/shuttle/salvaged_shuttle)
"HR" = (
/obj/structure/railing/eva_handhold/directional/south,
/obj/structure/railing/eva_handhold/directional/north,
/obj/structure/marker_beacon/yellow,
/turf/open/floor/engine/anchor_jack,
/area/shuttle/salvaged_shuttle)
"Ii" = (
/obj/structure/railing/eva_handhold/directional/south,
/obj/structure/railing/eva_handhold/directional/north,
/obj/effect/mapping_helpers/salvage_anchor/one,
/obj/structure/marker_beacon/jade,
/turf/open/floor/engine/anchor_jack,
/area/shuttle/salvaged_shuttle)
"Im" = (
/obj/structure/titanium_structure,
/obj/structure/shuttle_decoration/wall_plate/armor{
	dir = 1
	},
/obj/structure/shuttle_decoration/eva_catwalks/directional/north,
/obj/structure/railing/eva_handhold/directional/north,
/turf/open/floor/plating/nanocarbon/exterior/black,
/area/shuttle/salvaged_shuttle)
"IG" = (
/obj/structure/shuttle_decoration/junction_box/directional/west,
/turf/closed/wall/mineral/aluminum,
/area/shuttle/salvaged_shuttle)
"IM" = (
/obj/effect/mapping_helpers/salvage_anchor/end/four,
/turf/closed/wall/mineral/nanocarbon/nodiagonal/black,
/area/shuttle/salvaged_shuttle)
"IP" = (
/obj/structure/shuttle_decoration/wall_plate/silver_foil,
/obj/structure/shuttle_decoration/wall_plate/nanocarbon/secondary_colour{
	dir = 1
	},
/turf/closed/wall/mineral/nanocarbon/nodiagonal/secondary_colour,
/area/shuttle/salvaged_shuttle)
"IZ" = (
/obj/structure/lattice/catwalk,
/obj/structure/shuttle_decoration/eva_catwalks/directional/south,
/turf/template_noop,
/area/shuttle/salvaged_shuttle)
"Jd" = (
/obj/structure/shuttle_decoration/radiator/directional/south,
/turf/closed/wall/mineral/nanocarbon/nodiagonal/primary_colour,
/area/shuttle/salvaged_shuttle)
"Kk" = (
/obj/structure/lattice,
/obj/structure/shuttle_decoration/wall_plate/armor,
/obj/structure/shuttle_decoration/eva_catwalks/directional/south,
/turf/template_noop,
/area/shuttle/salvaged_shuttle)
"KV" = (
/obj/structure/shuttle_decoration/wall_plate/armor{
	dir = 1
	},
/obj/structure/shuttle_decoration/wall_plate/armor{
	dir = 2
	},
/turf/closed/wall/mineral/aluminum,
/area/shuttle/salvaged_shuttle)
"LH" = (
/obj/machinery/light/red/directional/north,
/turf/open/floor/plating/nanocarbon,
/area/shuttle/salvaged_shuttle)
"LJ" = (
/obj/effect/mapping_helpers/salvage_anchor/end/one,
/turf/closed/wall/mineral/nanocarbon/nodiagonal/primary_colour,
/area/shuttle/salvaged_shuttle)
"LV" = (
/obj/effect/spawner/random/salvage/crate_only/salvage,
/turf/open/floor/iron/colony/nanocarbon,
/area/shuttle/salvaged_shuttle)
"Md" = (
/obj/machinery/light/red/directional/west,
/turf/open/floor/plating/nanocarbon,
/area/shuttle/salvaged_shuttle)
"Mn" = (
/obj/structure/lattice,
/obj/structure/titanium_structure,
/obj/structure/shuttle_decoration/wall_plate/nanocarbon/primary_colour{
	dir = 1
	},
/obj/structure/shuttle_decoration/eva_catwalks/directional/north,
/obj/structure/railing/eva_handhold/directional/north,
/turf/template_noop,
/area/shuttle/salvaged_shuttle)
"MV" = (
/obj/docking_port/mobile/salvage,
/obj/structure/railing/eva_handhold/directional/south,
/obj/structure/railing/eva_handhold/directional/north,
/obj/structure/marker_beacon/yellow,
/turf/open/floor/engine/anchor_jack,
/area/shuttle/salvaged_shuttle)
"No" = (
/turf/open/floor/iron/colony/bolts/nanocarbon,
/area/shuttle/salvaged_shuttle)
"Nw" = (
/obj/structure/lattice/catwalk,
/obj/structure/shuttle_decoration/eva_catwalks/directional/north,
/turf/template_noop,
/area/shuttle/salvaged_shuttle)
"NP" = (
/obj/machinery/atmos_shield_gen/active{
	dir = 1
	},
/turf/open/floor/plating/nanocarbon,
/area/shuttle/salvaged_shuttle)
"Oe" = (
/obj/structure/mineral_door/manual_colony_door/shuttle/interior,
/turf/open/floor/iron/colony/white/texture/nanocarbon,
/area/shuttle/salvaged_shuttle)
"Ow" = (
/obj/structure/shuttle_decoration/wall_plate/silver_foil,
/turf/closed/wall/mineral/nanocarbon/nodiagonal/primary_colour,
/area/shuttle/salvaged_shuttle)
"Pp" = (
/obj/structure/mineral_door/manual_colony_door/shuttle,
/turf/open/floor/iron/colony/white/texture/nanocarbon,
/area/shuttle/salvaged_shuttle)
"Pq" = (
/obj/structure/lattice,
/obj/structure/shuttle_decoration/wall_plate/armor{
	dir = 1
	},
/obj/structure/shuttle_decoration/eva_catwalks/directional/north,
/turf/template_noop,
/area/shuttle/salvaged_shuttle)
"PS" = (
/obj/structure/shuttle_decoration/wall_plate/silver_foil,
/obj/structure/shuttle_decoration/extinguisher/directional/north,
/turf/closed/wall/mineral/nanocarbon/nodiagonal/primary_colour,
/area/shuttle/salvaged_shuttle)
"PU" = (
/obj/structure/shuttle_decoration/liquid_tank/explosive/lithium,
/turf/open/floor/plating/nanocarbon,
/area/shuttle/salvaged_shuttle)
"Qv" = (
/obj/structure/shuttle_access_panel,
/turf/open/floor/plating/nanocarbon,
/area/shuttle/salvaged_shuttle)
"Qx" = (
/obj/structure/shuttle_decoration/liquid_tank/explosive/hydrazine,
/turf/open/floor/plating/nanocarbon,
/area/shuttle/salvaged_shuttle)
"QB" = (
/obj/machinery/atmos_shield_gen/active,
/turf/open/floor/plating/nanocarbon,
/area/shuttle/salvaged_shuttle)
"QT" = (
/obj/effect/spawner/random/salvage/interior_trash_n_debris,
/turf/open/floor/iron/colony/bolts/nanocarbon,
/area/shuttle/salvaged_shuttle)
"Rr" = (
/obj/machinery/computer/old{
	dir = 8
	},
/turf/open/floor/iron/colony/nanocarbon,
/area/shuttle/salvaged_shuttle)
"RB" = (
/obj/structure/shuttle_decoration/wall_plate/silver_foil{
	dir = 1
	},
/obj/structure/shuttle_decoration/wall_plate/nanocarbon/secondary_colour,
/turf/closed/wall/mineral/nanocarbon/nodiagonal/secondary_colour,
/area/shuttle/salvaged_shuttle)
"RM" = (
/obj/structure/lattice,
/obj/structure/shuttle_decoration/wall_plate/nanocarbon/primary_colour,
/obj/structure/shuttle_decoration/eva_catwalks/directional/south,
/turf/template_noop,
/area/shuttle/salvaged_shuttle)
"RS" = (
/turf/closed/wall/mineral/nanocarbon/black,
/area/shuttle/salvaged_shuttle)
"Sd" = (
/obj/effect/mapping_helpers/salvage_anchor/end/eight,
/turf/closed/wall/mineral/nanocarbon/nodiagonal/primary_colour,
/area/shuttle/salvaged_shuttle)
"Sv" = (
/obj/structure/railing/eva_handhold/directional/south,
/obj/structure/railing/eva_handhold/directional/north,
/obj/effect/mapping_helpers/salvage_anchor/eight,
/obj/structure/marker_beacon/jade,
/turf/open/floor/engine/anchor_jack,
/area/shuttle/salvaged_shuttle)
"Tf" = (
/obj/structure/shuttle_decoration/wall_plate/plastamic{
	dir = 1
	},
/obj/structure/shuttle_decoration/liquid_tank/coolant,
/turf/open/floor/plating/nanocarbon,
/area/shuttle/salvaged_shuttle)
"Tm" = (
/turf/closed/wall/mineral/nanocarbon/nodiagonal/secondary_colour,
/area/shuttle/salvaged_shuttle)
"UE" = (
/obj/structure/chair/comfy/shuttle{
	dir = 4
	},
/obj/machinery/light/red/directional/north,
/turf/open/floor/plating/nanocarbon/exterior/standard,
/area/shuttle/salvaged_shuttle)
"UN" = (
/obj/effect/spawner/random/salvage/nanocarbon_shards,
/turf/open/floor/plating/aluminum,
/area/shuttle/salvaged_shuttle)
"UU" = (
/turf/closed/wall/mineral/aluminum,
/area/shuttle/salvaged_shuttle)
"UW" = (
/obj/structure/shuttle_decoration/rcs,
/turf/closed/wall/mineral/nanocarbon/nodiagonal/primary_colour,
/area/shuttle/salvaged_shuttle)
"VR" = (
/obj/structure/lattice,
/obj/structure/titanium_structure,
/obj/structure/shuttle_decoration/wall_plate/nanocarbon/diagonal/primary_colour,
/turf/template_noop,
/area/shuttle/salvaged_shuttle)
"Wc" = (
/obj/machinery/power/shuttle_engine/heater/salvage{
	dir = 8
	},
/obj/structure/engine_covers/heater_cover{
	dir = 4
	},
/turf/open/floor/plating/nanocarbon,
/area/shuttle/salvaged_shuttle)
"Wg" = (
/obj/effect/mapping_helpers/salvage_anchor/end/five,
/turf/closed/wall/mineral/nanocarbon/primary_colour,
/area/shuttle/salvaged_shuttle)
"WE" = (
/obj/structure/shuttle_decoration/console/directional/north,
/turf/closed/wall/mineral/nanocarbon/nodiagonal/secondary_colour,
/area/shuttle/salvaged_shuttle)
"Xt" = (
/obj/effect/spawner/random/salvage/interior_trash_n_debris,
/turf/open/floor/catwalk_floor/colony_fabricator/nanocarbon,
/area/shuttle/salvaged_shuttle)
"Yt" = (
/obj/structure/shuttle_decoration/eva_catwalks/directional/east,
/turf/closed/wall/mineral/nanocarbon/nodiagonal/primary_colour,
/area/shuttle/salvaged_shuttle)
"YC" = (
/turf/template_noop,
/area/template_noop)
"YJ" = (
/obj/structure/shuttle_decoration/liquid_tank/explosive,
/turf/open/floor/plating/nanocarbon,
/area/shuttle/salvaged_shuttle)
"YR" = (
/obj/structure/shuttle_decoration/junction_box/directional/south,
/obj/structure/shuttle_decoration/rcs/directional/north,
/turf/closed/wall/mineral/nanocarbon/nodiagonal/primary_colour,
/area/shuttle/salvaged_shuttle)
"Zq" = (
/obj/structure/shuttle_decoration/wall_plate/silver_foil{
	dir = 1
	},
/obj/effect/mapping_helpers/salvage_anchor/end/two,
/turf/closed/wall/mineral/nanocarbon/nodiagonal/secondary_colour,
/area/shuttle/salvaged_shuttle)
"Zy" = (
/obj/structure/shuttle_decoration/console/directional/south,
/turf/closed/wall/mineral/aluminum,
/area/shuttle/salvaged_shuttle)

(1,1,1) = {"
YC
YC
YC
YC
YC
YC
YC
YC
YC
YC
YC
YC
YC
YC
YC
YC
YC
YC
YC
"}
(2,1,1) = {"
YC
YC
YC
YC
YC
YC
YC
YC
YC
YC
YC
YC
YC
YC
YC
YC
YC
YC
YC
"}
(3,1,1) = {"
YC
YC
YC
YC
YC
KV
YC
YC
YC
YC
YC
YC
YC
KV
YC
YC
YC
YC
YC
"}
(4,1,1) = {"
YC
Sv
YC
YC
wC
KV
YC
YC
YC
YC
YC
YC
YC
KV
EQ
YC
YC
Ii
YC
"}
(5,1,1) = {"
YC
YC
YC
YC
zl
yu
gM
YC
YC
YC
YC
YC
BW
yu
VR
YC
YC
YC
YC
"}
(6,1,1) = {"
YC
YC
YC
YC
md
Sd
jX
YC
YC
YC
YC
YC
Im
LJ
Ex
YC
YC
YC
YC
"}
(7,1,1) = {"
YC
YC
YC
YC
yu
yu
Kk
YC
YC
YC
YC
YC
Pq
yu
yu
YC
YC
YC
YC
"}
(8,1,1) = {"
YC
HR
YC
YC
hx
UU
fI
YC
YC
YC
YC
YC
Mn
UU
Jd
YC
YC
HR
YC
"}
(9,1,1) = {"
YC
YC
YC
YC
hx
UE
RM
YC
YC
YC
YC
YC
mj
sj
Jd
YC
YC
YC
YC
"}
(10,1,1) = {"
YC
YC
kZ
YC
pa
Ew
Gu
YC
YC
YC
YC
YC
bo
Ew
km
YC
kZ
YC
YC
"}
(11,1,1) = {"
YC
YC
kZ
BV
Tm
UU
IZ
YC
YC
YC
YC
YC
Nw
UU
Tm
BV
kZ
YC
YC
"}
(12,1,1) = {"
uk
YC
jv
xx
eB
UU
QB
yi
NP
BC
QB
tC
NP
UU
rL
xx
uL
YC
vE
"}
(13,1,1) = {"
YC
YC
ik
Wc
iA
Md
HG
zm
rb
Md
rb
UN
zm
Md
Du
Wc
Zq
YC
YC
"}
(14,1,1) = {"
YC
YC
Ow
YJ
iA
No
rb
rb
zm
No
UN
zm
rb
No
Du
Qx
iz
YC
YC
"}
(15,1,1) = {"
YC
YC
PS
LH
Qv
kO
zm
rb
rb
kO
rb
zm
rb
Xt
Qv
gX
cC
YC
YC
"}
(16,1,1) = {"
HR
YC
rL
PU
RB
QT
rb
zm
zm
No
zm
rb
zm
No
IP
Gy
qp
YC
MV
"}
(17,1,1) = {"
YC
YC
rL
ce
RB
yi
zm
zm
rb
iy
HG
rb
zm
iy
IP
ce
eB
YC
YC
"}
(18,1,1) = {"
YC
YC
ly
cP
iA
iy
yi
tC
IG
nN
Dx
Dx
Dx
UU
Ow
cP
xs
YC
YC
"}
(19,1,1) = {"
YC
YC
Bw
BV
yu
UU
Pp
UU
Zy
nP
kP
CC
kP
ym
bv
BV
qY
YC
YC
"}
(20,1,1) = {"
Dm
YC
YC
YC
Tm
uK
kO
Tf
UU
LV
nk
Fz
nk
ym
WE
YC
YC
YC
Em
"}
(21,1,1) = {"
YC
YC
YC
YC
AC
UU
Pp
UU
UU
LV
nk
lO
ez
LV
oM
YC
YC
YC
YC
"}
(22,1,1) = {"
YC
YC
YC
YC
Fg
zd
nk
kP
UU
UU
Oe
UU
IG
Aq
yu
YC
YC
YC
YC
"}
(23,1,1) = {"
YC
YC
YC
YC
fe
zd
Xt
Fz
Oe
kO
vn
kO
Pp
vn
Pp
YC
YC
YC
YC
"}
(24,1,1) = {"
YC
HR
YC
YC
YR
kP
kO
Dp
yu
UU
UU
UU
UU
sl
UW
YC
YC
HR
YC
"}
(25,1,1) = {"
YC
YC
YC
YC
Fg
zd
CC
Aj
yu
yx
pH
wJ
Yt
yu
yu
YC
YC
YC
YC
"}
(26,1,1) = {"
YC
YC
YC
YC
Wg
yu
kP
Dp
Dx
YC
YC
YC
YC
CU
IM
YC
YC
YC
YC
"}
(27,1,1) = {"
YC
YC
YC
YC
YC
Dx
CC
Rr
Dx
YC
YC
YC
YC
Av
RS
YC
YC
YC
YC
"}
(28,1,1) = {"
YC
dD
YC
YC
YC
yu
Dx
Dx
yu
YC
YC
YC
YC
YC
YC
YC
YC
Ev
YC
"}
(29,1,1) = {"
YC
YC
YC
YC
YC
YC
YC
YC
YC
YC
YC
YC
YC
YC
YC
YC
YC
YC
YC
"}
(30,1,1) = {"
YC
YC
YC
YC
YC
YC
YC
YC
YC
YC
YC
YC
YC
YC
YC
YC
YC
YC
YC
"}
(31,1,1) = {"
YC
YC
YC
YC
YC
YC
YC
YC
YC
YC
YC
YC
YC
YC
YC
YC
YC
YC
YC
"}
