//MAP CONVERTED BY dmm2tgm.py THIS HEADER COMMENT PREVENTS RECONVERSION, DO NOT REMOVE
"a" = (
/turf/template_noop,
/area/template_noop)
"h" = (
/obj/item/radio/intercom/directional/north,
/obj/effect/turf_decal/trimline/neutral/filled/line{
	dir = 1
	},
/obj/machinery/vending/hydronutrients,
/turf/open/floor/iron,
/area/station/service/hydroponics/garden)
"k" = (
/obj/machinery/light/directional/south,
/obj/machinery/hydroponics/constructable,
/turf/open/floor/grass,
/area/station/service/hydroponics/garden)
"n" = (
/obj/effect/turf_decal/trimline/neutral/filled/line{
	dir = 9
	},
/obj/machinery/airalarm/directional/west,
/obj/machinery/vending/hydroseeds,
/turf/open/floor/iron,
/area/station/service/hydroponics/garden)
"v" = (
/obj/machinery/hydroponics/constructable,
/turf/open/floor/grass,
/area/station/service/hydroponics/garden)
"K" = (
/obj/item/crowbar,
/obj/item/storage/bag/plants,
/obj/item/hatchet,
/obj/item/plant_analyzer,
/obj/item/cultivator,
/obj/effect/turf_decal/trimline/neutral/filled/line{
	dir = 1
	},
/obj/machinery/newscaster/directional/north,
/obj/structure/table/wood,
/obj/item/reagent_containers/cup/watering_can,
/turf/open/floor/iron,
/area/station/service/hydroponics/garden)

(1,1,1) = {"
n
a
a
v
"}
(2,1,1) = {"
K
a
a
k
"}
(3,1,1) = {"
h
a
a
v
"}
(4,1,1) = {"
a
a
a
v
"}
(5,1,1) = {"
a
a
a
a
"}
(6,1,1) = {"
a
a
a
a
"}
(7,1,1) = {"
a
a
a
a
"}
(8,1,1) = {"
a
a
a
a
"}
(9,1,1) = {"
a
a
a
a
"}
