//MAP CONVERTED BY dmm2tgm.py THIS HEADER COMMENT PREVENTS RECONVERSION, DO NOT REMOVE
"a" = (
/turf/template_noop,
/area/template_noop)
"f" = (
/obj/structure/table/wood,
/obj/item/reagent_containers/cup/glass/shaker,
/obj/machinery/light/warm/directional/east,
/obj/item/holosign_creator/robot_seat/bar,
/turf/open/floor/wood,
/area/station/service/bar/backroom)
"R" = (
/obj/structure/closet/secure_closet/security/service,
/turf/open/floor/wood,
/area/station/service/bar/backroom)

(1,1,1) = {"
a
a
a
"}
(2,1,1) = {"
a
a
a
"}
(3,1,1) = {"
a
a
a
"}
(4,1,1) = {"
a
a
a
"}
(5,1,1) = {"
a
a
a
"}
(6,1,1) = {"
a
a
a
"}
(7,1,1) = {"
a
f
R
"}
