//MAP CONVERTED BY dmm2tgm.py THIS HEADER COMMENT PREVENTS RECONVERSION, DO NOT REMOVE
"a" = (
/turf/template_noop,
/area/template_noop)
"p" = (
/obj/effect/turf_decal/trimline/dark_red/line{
	dir = 1
	},
/obj/machinery/light_switch/directional/south,
/obj/effect/turf_decal/trimline/dark_red/filled/line,
/obj/structure/railing{
	dir = 8
	},
/obj/machinery/camera/autoname/directional/south,
/obj/structure/closet/secure_closet/security/service,
/turf/open/floor/iron/dark/small,
/area/station/service/bar/backroom)

(1,1,1) = {"
a
a
a
"}
(2,1,1) = {"
a
a
a
"}
(3,1,1) = {"
a
a
a
"}
(4,1,1) = {"
a
a
a
"}
(5,1,1) = {"
a
a
p
"}
(6,1,1) = {"
a
a
a
"}
(7,1,1) = {"
a
a
a
"}
