//MAP CONVERTED BY dmm2tgm.py THIS HEADER COMMENT PREVENTS RECONVERSION, DO NOT REMOVE
"a" = (
/turf/template_noop,
/area/template_noop)
"l" = (
/obj/effect/turf_decal/bot,
/obj/structure/rack/gunrack,
/obj/effect/spawner/armory_spawn/mod_lasers_big,
/obj/effect/landmark/event_spawn,
/turf/open/floor/iron/dark/textured_large,
/area/station/ai_monitored/security/armory)
"p" = (
/obj/structure/cable,
/obj/machinery/atmospherics/pipe/smart/manifold4w/scrubbers/hidden/layer2,
/obj/structure/rack/gunrack,
/obj/effect/spawner/armory_spawn/shotguns,
/turf/open/floor/iron/dark/textured_large,
/area/station/ai_monitored/security/armory)
"s" = (
/obj/structure/rack,
/obj/item/gun/energy/e_gun/dragnet{
	pixel_y = 4
	},
/obj/item/gun/energy/e_gun/dragnet,
/obj/effect/turf_decal/bot/right,
/obj/machinery/airalarm/directional/north,
/obj/item/melee/breaching_hammer,
/obj/item/melee/breaching_hammer,
/obj/item/melee/breaching_hammer,
/obj/item/melee/breaching_hammer,
/turf/open/floor/iron/dark/textured_large,
/area/station/ai_monitored/security/armory)
"L" = (
/obj/effect/turf_decal/bot,
/obj/structure/rack/gunrack,
/obj/effect/spawner/armory_spawn/smg,
/turf/open/floor/iron/dark/textured_large,
/area/station/ai_monitored/security/armory)
"R" = (
/obj/effect/turf_decal/bot,
/obj/structure/rack/gunrack,
/obj/effect/spawner/armory_spawn/mod_lasers_small,
/turf/open/floor/iron/dark/textured_large,
/area/station/ai_monitored/security/armory)

(1,1,1) = {"
a
a
a
a
a
a
a
a
a
a
a
"}
(2,1,1) = {"
a
a
a
a
a
a
a
a
a
a
a
"}
(3,1,1) = {"
a
a
a
a
a
a
a
a
a
a
a
"}
(4,1,1) = {"
a
a
a
a
a
a
a
L
a
a
a
"}
(5,1,1) = {"
a
a
a
a
a
a
p
l
a
a
a
"}
(6,1,1) = {"
a
a
a
a
a
a
a
R
a
a
a
"}
(7,1,1) = {"
a
a
a
a
a
s
a
a
a
a
a
"}
(8,1,1) = {"
a
a
a
a
a
a
a
a
a
a
a
"}
(9,1,1) = {"
a
a
a
a
a
a
a
a
a
a
a
"}
(10,1,1) = {"
a
a
a
a
a
a
a
a
a
a
a
"}
