//MAP CONVERTED BY dmm2tgm.py THIS HEADER COMMENT PREVENTS RECONVERSION, DO NOT REMOVE
"a" = (
/turf/template_noop,
/area/template_noop)
"g" = (
/obj/machinery/status_display/evac/directional/east,
/obj/machinery/light/directional/east,
/obj/machinery/hydroponics/constructable,
/turf/open/floor/grass,
/area/station/service/hydroponics/garden)
"v" = (
/obj/machinery/light_switch/directional/east,
/obj/machinery/hydroponics/constructable,
/turf/open/floor/grass,
/area/station/service/hydroponics/garden)
"y" = (
/obj/effect/turf_decal/tile/green/half/contrasted,
/obj/machinery/newscaster/directional/east,
/obj/machinery/vending/hydronutrients,
/turf/open/floor/iron/dark,
/area/station/service/hydroponics/garden)
"C" = (
/obj/machinery/hydroponics/constructable,
/turf/open/floor/grass,
/area/station/service/hydroponics/garden)
"M" = (
/obj/machinery/firealarm/directional/west,
/obj/machinery/hydroponics/constructable,
/turf/open/floor/grass,
/area/station/service/hydroponics/garden)
"U" = (
/obj/effect/turf_decal/tile/green/half/contrasted,
/obj/machinery/vending/hydroseeds,
/turf/open/floor/iron/dark,
/area/station/service/hydroponics/garden)

(1,1,1) = {"
a
a
a
a
a
a
a
a
a
"}
(2,1,1) = {"
a
a
a
a
a
a
a
a
a
"}
(3,1,1) = {"
a
a
a
a
a
a
a
a
a
"}
(4,1,1) = {"
a
a
a
a
a
a
a
a
a
"}
(5,1,1) = {"
a
a
a
a
a
a
a
a
a
"}
(6,1,1) = {"
U
a
C
M
a
a
a
a
a
"}
(7,1,1) = {"
a
a
a
a
a
a
a
a
a
"}
(8,1,1) = {"
a
a
a
a
a
a
a
a
a
"}
(9,1,1) = {"
y
a
g
v
a
a
a
a
a
"}
