//MAP CONVERTED BY dmm2tgm.py THIS HEADER COMMENT PREVENTS RECONVERSION, DO NOT REMOVE
"a" = (
/turf/open/floor/carpet/executive,
/area/station/command/heads_quarters/nt_rep)
"b" = (
/obj/structure/chair/office{
	dir = 4
	},
/obj/effect/turf_decal/siding/wood,
/turf/open/floor/wood/large,
/area/station/command/heads_quarters/nt_rep)
"c" = (
/obj/effect/turf_decal/siding/wood{
	dir = 1
	},
/obj/machinery/status_display/evac/directional/south,
/obj/effect/turf_decal/siding/wood,
/obj/machinery/light/directional/south,
/obj/effect/spawner/random/food_or_drink/donkpockets,
/obj/structure/table,
/turf/open/floor/wood/large,
/area/station/command/heads_quarters/nt_rep)
"d" = (
/obj/structure/hedge,
/obj/effect/turf_decal/siding/wood{
	dir = 1
	},
/obj/effect/turf_decal/siding/wood,
/turf/open/floor/wood/large,
/area/station/command/heads_quarters/nt_rep)
"f" = (
/obj/structure/cable,
/turf/open/floor/carpet/executive,
/area/station/command/heads_quarters/nt_rep)
"g" = (
/obj/machinery/atmospherics/components/unary/vent_pump/on/layer4{
	dir = 1
	},
/obj/machinery/light_switch/directional/east,
/obj/effect/turf_decal/siding/wood{
	dir = 6
	},
/turf/open/floor/wood/large,
/area/station/command/heads_quarters/nt_rep)
"h" = (
/obj/structure/table/wood,
/obj/effect/spawner/random/bureaucracy/folder{
	spawn_random_offset = 1
	},
/obj/effect/spawner/random/bureaucracy/pen,
/obj/effect/turf_decal/siding/wood{
	dir = 9
	},
/turf/open/floor/wood/large,
/area/station/command/heads_quarters/nt_rep)
"i" = (
/obj/structure/filingcabinet,
/obj/effect/turf_decal/siding/wood{
	dir = 5
	},
/turf/open/floor/wood/large,
/area/station/command/heads_quarters/nt_rep)
"j" = (
/obj/machinery/atmospherics/pipe/smart/manifold4w/scrubbers/hidden/layer2,
/obj/structure/cable,
/turf/open/floor/wood/large,
/area/station/command/heads_quarters/nt_rep)
"k" = (
/obj/machinery/modular_computer/preset/command{
	dir = 8
	},
/turf/open/floor/carpet/executive,
/area/station/command/heads_quarters/nt_rep)
"l" = (
/obj/structure/cable,
/obj/machinery/atmospherics/pipe/smart/manifold4w/supply/hidden/layer4,
/obj/machinery/atmospherics/pipe/smart/manifold4w/scrubbers/hidden/layer2,
/obj/structure/disposalpipe/segment,
/obj/effect/turf_decal/tile/neutral{
	dir = 8
	},
/turf/open/floor/iron,
/area/station/hallway/primary/central)
"m" = (
/obj/effect/turf_decal/siding/wood{
	dir = 8
	},
/obj/effect/turf_decal/siding/wood/corner{
	dir = 4
	},
/turf/open/floor/wood/large,
/area/station/command/heads_quarters/nt_rep)
"n" = (
/obj/structure/table/wood,
/obj/structure/cable,
/obj/item/stamp{
	pixel_x = -2;
	pixel_y = 6
	},
/obj/item/stamp/denied{
	pixel_x = 8;
	pixel_y = 6
	},
/obj/item/stamp/centcom{
	pixel_x = 4
	},
/turf/open/floor/carpet/executive,
/area/station/command/heads_quarters/nt_rep)
"o" = (
/obj/effect/turf_decal/siding/wood{
	dir = 8
	},
/obj/machinery/atmospherics/components/unary/vent_scrubber/on/layer2{
	dir = 1
	},
/obj/machinery/computer/security/telescreen/entertainment/directional/west,
/obj/effect/turf_decal/siding/wood/corner,
/turf/open/floor/wood/large,
/area/station/command/heads_quarters/nt_rep)
"q" = (
/obj/effect/turf_decal/siding/wood,
/turf/open/floor/wood/large,
/area/station/command/heads_quarters/nt_rep)
"r" = (
/obj/machinery/status_display/evac/directional/west,
/obj/structure/cable,
/obj/machinery/atmospherics/pipe/smart/manifold4w/supply/hidden/layer4,
/obj/machinery/atmospherics/pipe/smart/manifold4w/scrubbers/hidden/layer2,
/obj/structure/disposalpipe/segment,
/turf/open/floor/iron,
/area/station/hallway/primary/central)
"s" = (
/obj/structure/filingcabinet,
/obj/effect/turf_decal/siding/wood{
	dir = 1
	},
/turf/open/floor/wood/large,
/area/station/command/heads_quarters/nt_rep)
"t" = (
/obj/effect/turf_decal/siding/wood{
	dir = 4
	},
/obj/effect/turf_decal/siding/wood{
	dir = 8
	},
/turf/open/floor/wood/large,
/area/station/command/heads_quarters/nt_rep)
"u" = (
/obj/machinery/door/airlock/maintenance,
/obj/effect/mapping_helpers/airlock/access/all/cent_com/rep_door,
/turf/open/floor/plating,
/area/station/command/heads_quarters/nt_rep)
"v" = (
/obj/machinery/holopad,
/turf/open/floor/carpet/executive,
/area/station/command/heads_quarters/nt_rep)
"w" = (
/obj/machinery/door/firedoor,
/obj/structure/cable,
/obj/machinery/atmospherics/pipe/smart/manifold4w/scrubbers/hidden/layer2,
/obj/machinery/atmospherics/pipe/smart/manifold4w/supply/hidden/layer4,
/obj/machinery/door/airlock/corporate{
	name = "NT Consultant's Office"
	},
/obj/effect/mapping_helpers/airlock/access/all/cent_com/rep_door,
/turf/open/floor/wood/large,
/area/station/command/heads_quarters/nt_rep)
"x" = (
/obj/effect/turf_decal/siding/wood/corner{
	dir = 4
	},
/obj/effect/turf_decal/siding/wood{
	dir = 10
	},
/obj/machinery/power/apc/auto_name/directional/south,
/obj/structure/cable,
/obj/machinery/smartfridge/food,
/turf/open/floor/wood/large,
/area/station/command/heads_quarters/nt_rep)
"y" = (
/turf/template_noop,
/area/template_noop)
"z" = (
/obj/structure/table/wood,
/obj/machinery/fax,
/obj/effect/turf_decal/siding/wood/end,
/turf/open/floor/wood/large,
/area/station/command/heads_quarters/nt_rep)
"A" = (
/obj/effect/turf_decal/siding/wood/corner{
	dir = 4
	},
/turf/open/floor/wood/large,
/area/station/command/heads_quarters/nt_rep)
"B" = (
/obj/effect/turf_decal/tile/neutral{
	dir = 8
	},
/obj/structure/cable,
/obj/machinery/atmospherics/pipe/smart/manifold4w/supply/hidden/layer4,
/obj/machinery/atmospherics/pipe/smart/manifold4w/scrubbers/hidden/layer2,
/obj/structure/disposalpipe/segment{
	dir = 5
	},
/obj/structure/extinguisher_cabinet/directional/south,
/turf/open/floor/iron,
/area/station/hallway/primary/central)
"C" = (
/obj/structure/cable,
/obj/structure/chair/office{
	dir = 4
	},
/obj/effect/landmark/start/nanotrasen_consultant,
/turf/open/floor/carpet/executive,
/area/station/command/heads_quarters/nt_rep)
"D" = (
/turf/closed/wall/r_wall,
/area/station/command/heads_quarters/nt_rep)
"E" = (
/obj/structure/table/wood,
/obj/item/pen/blue{
	pixel_x = 5;
	pixel_y = 5
	},
/obj/item/flashlight/lamp/green{
	pixel_x = -5;
	pixel_y = 3
	},
/obj/item/book/manual/wiki/security_space_law{
	pixel_x = 7
	},
/obj/effect/turf_decal/siding/wood{
	dir = 6
	},
/turf/open/floor/wood/large,
/area/station/command/heads_quarters/nt_rep)
"F" = (
/obj/effect/turf_decal/siding/wood{
	dir = 4
	},
/obj/effect/turf_decal/siding/wood{
	dir = 8
	},
/obj/machinery/button/door/directional/west{
	id = "nt_rep_priv";
	name = "Privacy Shutters Control";
	pixel_y = 8
	},
/turf/open/floor/wood/large,
/area/station/command/heads_quarters/nt_rep)
"G" = (
/obj/structure/rack,
/obj/effect/spawner/random/bureaucracy/briefcase{
	spawn_loot_count = 2;
	spawn_loot_split = 1
	},
/obj/effect/spawner/random/bureaucracy/briefcase{
	spawn_loot_count = 2;
	spawn_loot_split = 1
	},
/obj/effect/turf_decal/siding/wood/end{
	dir = 4
	},
/turf/open/floor/wood/large,
/area/station/command/heads_quarters/nt_rep)
"I" = (
/obj/machinery/firealarm/directional/east,
/obj/item/kirbyplants/organic/plant22,
/obj/effect/turf_decal/siding/wood{
	dir = 5
	},
/turf/open/floor/wood/large,
/area/station/command/heads_quarters/nt_rep)
"J" = (
/obj/effect/turf_decal/siding/wood{
	dir = 8
	},
/turf/open/floor/wood/large,
/area/station/command/heads_quarters/nt_rep)
"K" = (
/obj/machinery/door/poddoor/preopen{
	id = "nt_rep_priv";
	name = "Privacy Shutter"
	},
/obj/effect/spawner/structure/window/reinforced,
/turf/open/floor/plating,
/area/station/command/heads_quarters/nt_rep)
"L" = (
/obj/structure/reagent_dispensers/water_cooler,
/obj/effect/turf_decal/siding/wood{
	dir = 8
	},
/obj/effect/turf_decal/siding/wood{
	dir = 5
	},
/turf/open/floor/wood/large,
/area/station/command/heads_quarters/nt_rep)
"M" = (
/turf/open/floor/wood/large,
/area/station/command/heads_quarters/nt_rep)
"O" = (
/obj/effect/turf_decal/siding/wood{
	dir = 4
	},
/obj/machinery/atmospherics/pipe/smart/manifold4w/supply/hidden/layer4,
/obj/structure/cable,
/obj/machinery/atmospherics/pipe/smart/manifold4w/scrubbers/hidden/layer2,
/turf/open/floor/wood/large,
/area/station/command/heads_quarters/nt_rep)
"P" = (
/obj/item/radio/intercom/directional/west,
/obj/effect/turf_decal/siding/wood{
	dir = 9
	},
/obj/structure/chair/office{
	dir = 4
	},
/turf/open/floor/wood/large,
/area/station/command/heads_quarters/nt_rep)
"Q" = (
/obj/effect/turf_decal/siding/wood{
	dir = 10
	},
/obj/structure/closet/secure_closet/nanotrasen_consultant,
/obj/machinery/newscaster/directional/west,
/obj/effect/turf_decal/siding/wood{
	dir = 4
	},
/turf/open/floor/wood/large,
/area/station/command/heads_quarters/nt_rep)
"S" = (
/turf/template_noop,
/area/station/hallway/primary/port)
"T" = (
/obj/effect/turf_decal/siding/wood{
	dir = 1
	},
/obj/effect/turf_decal/siding/wood,
/obj/machinery/airalarm/directional/south,
/obj/machinery/camera/autoname/directional/south,
/obj/structure/table,
/obj/machinery/microwave,
/turf/open/floor/wood/large,
/area/station/command/heads_quarters/nt_rep)
"U" = (
/obj/structure/table/wood,
/obj/item/paper_bin{
	pixel_x = -2;
	pixel_y = 6
	},
/obj/effect/spawner/random/bureaucracy/pen,
/obj/effect/turf_decal/siding/wood{
	dir = 9
	},
/turf/open/floor/wood/large,
/area/station/command/heads_quarters/nt_rep)
"V" = (
/obj/effect/turf_decal/siding/wood/corner,
/obj/effect/turf_decal/siding/wood/corner{
	dir = 8
	},
/turf/open/floor/wood/large,
/area/station/command/heads_quarters/nt_rep)
"W" = (
/obj/effect/turf_decal/siding/wood{
	dir = 1
	},
/obj/effect/turf_decal/siding/wood/corner,
/turf/open/floor/wood/large,
/area/station/command/heads_quarters/nt_rep)
"X" = (
/obj/effect/turf_decal/siding/wood{
	dir = 8
	},
/obj/machinery/atmospherics/pipe/smart/manifold4w/scrubbers/hidden/layer2,
/obj/machinery/light/directional/west,
/turf/open/floor/wood/large,
/area/station/command/heads_quarters/nt_rep)
"Y" = (
/obj/structure/cable,
/obj/effect/turf_decal/siding/wood,
/turf/open/floor/wood/large,
/area/station/command/heads_quarters/nt_rep)
"Z" = (
/obj/structure/table/wood,
/obj/item/flashlight/lamp/green{
	pixel_x = 5;
	pixel_y = 8
	},
/turf/open/floor/carpet/executive,
/area/station/command/heads_quarters/nt_rep)

(1,1,1) = {"
y
D
D
D
D
u
D
D
D
y
y
"}
(2,1,1) = {"
S
K
P
X
o
t
F
Q
D
D
y
"}
(3,1,1) = {"
S
K
h
j
Y
n
C
f
x
D
y
"}
(4,1,1) = {"
S
K
U
j
q
Z
k
a
c
D
y
"}
(5,1,1) = {"
S
K
I
O
g
a
v
a
T
D
y
"}
(6,1,1) = {"
S
D
D
w
D
L
m
J
d
D
D
"}
(7,1,1) = {"
y
r
l
B
D
K
s
M
V
z
D
"}
(8,1,1) = {"
y
y
y
y
y
K
i
A
b
D
D
"}
(9,1,1) = {"
y
y
y
y
y
K
K
W
E
D
y
"}
(10,1,1) = {"
y
y
y
y
y
y
K
G
D
D
y
"}
(11,1,1) = {"
y
y
y
y
y
y
D
D
D
y
y
"}
