//MAP CONVERTED BY dmm2tgm.py THIS HEADER COMMENT PREVENTS RECONVERSION, DO NOT REMOVE
"ah" = (
/obj/effect/turf_decal/siding/dark{
	dir = 4
	},
/turf/open/floor/plating,
/area/misc/infiltrator_memory)
"at" = (
/obj/structure/sign/warning/docking/directional/south,
/turf/open/floor/plating,
/area/misc/infiltrator_memory)
"cy" = (
/obj/effect/turf_decal/siding/dark/corner{
	dir = 8
	},
/obj/effect/turf_decal/vg_decals/numbers/zero,
/turf/open/floor/plating,
/area/misc/infiltrator_memory)
"eM" = (
/obj/effect/turf_decal/siding/dark/corner{
	dir = 4
	},
/obj/effect/turf_decal/vg_decals/numbers/nine,
/turf/open/floor/plating,
/area/misc/infiltrator_memory)
"fv" = (
/obj/structure/fans/tiny/shield,
/obj/machinery/door/poddoor/preopen,
/turf/open/floor/plating,
/area/misc/infiltrator_memory)
"fO" = (
/obj/effect/turf_decal/siding/dark/corner{
	dir = 8
	},
/turf/open/floor/plating,
/area/misc/infiltrator_memory)
"gM" = (
/obj/structure/sign/warning/docking/directional/west,
/turf/open/floor/plating,
/area/misc/infiltrator_memory)
"hc" = (
/turf/open/space,
/area/space)
"hR" = (
/turf/closed/indestructible/syndicate,
/area/misc/infiltrator_memory)
"iJ" = (
/obj/effect/spawner/structure/window/reinforced/plasma/plastitanium,
/turf/open/floor/plating,
/area/misc/infiltrator_memory)
"jj" = (
/obj/effect/turf_decal/siding/dark{
	dir = 8
	},
/turf/open/floor/iron/dark/smooth_large,
/area/misc/infiltrator_memory)
"kA" = (
/obj/structure/railing/corner/end/unbreakable,
/obj/structure/railing/corner/end/flip/unbreakable,
/obj/effect/light_emitter/thunderdome,
/turf/open/floor/iron/dark/small,
/area/misc/infiltrator_memory)
"kJ" = (
/obj/effect/turf_decal/siding/dark{
	dir = 6
	},
/turf/open/floor/plating,
/area/misc/infiltrator_memory)
"lz" = (
/turf/open/space/basic,
/area/space)
"mF" = (
/obj/structure/lattice,
/turf/open/space/basic,
/area/space/nearstation)
"pI" = (
/obj/effect/turf_decal/vg_decals/numbers/zero,
/turf/open/floor/plating,
/area/misc/infiltrator_memory)
"qe" = (
/obj/effect/light_emitter/thunderdome,
/turf/open/floor/plating,
/area/misc/infiltrator_memory)
"rm" = (
/obj/effect/turf_decal/stripes/white/line{
	dir = 4
	},
/turf/open/floor/iron/dark/smooth_large,
/area/misc/infiltrator_memory)
"rq" = (
/obj/effect/turf_decal/siding/dark{
	dir = 1
	},
/obj/docking_port/stationary/infiltrator{
	dir = 2
	},
/turf/open/floor/plating,
/area/misc/infiltrator_memory)
"sz" = (
/obj/structure/marker_beacon/burgundy{
	pixel_x = 8;
	pixel_y = -8
	},
/turf/open/floor/iron/dark/textured_corner,
/area/misc/infiltrator_memory)
"to" = (
/turf/open/floor/catwalk_floor/airless,
/area/misc/infiltrator_memory)
"ty" = (
/obj/effect/turf_decal/stripes/white/corner{
	dir = 8
	},
/obj/structure/marker_beacon/bronze{
	pixel_x = 8;
	pixel_y = 8
	},
/turf/open/floor/iron/dark/textured_corner{
	dir = 4
	},
/area/misc/infiltrator_memory)
"ul" = (
/obj/effect/turf_decal/siding/dark/corner,
/turf/open/floor/plating,
/area/misc/infiltrator_memory)
"vs" = (
/obj/structure/sign/warning/docking/directional/east,
/turf/open/floor/plating,
/area/misc/infiltrator_memory)
"vQ" = (
/obj/structure/marker_beacon/bronze{
	pixel_x = 8;
	pixel_y = -8
	},
/obj/effect/turf_decal/siding/dark/corner{
	dir = 1
	},
/turf/open/floor/iron/dark/textured_corner,
/area/misc/infiltrator_memory)
"wQ" = (
/obj/effect/turf_decal/siding/dark/corner{
	dir = 4
	},
/turf/open/floor/plating,
/area/misc/infiltrator_memory)
"wT" = (
/obj/structure/railing/corner/end/flip/unbreakable{
	dir = 8
	},
/obj/structure/railing/corner/end/unbreakable{
	dir = 8
	},
/turf/open/floor/iron/dark/smooth_large,
/area/misc/infiltrator_memory)
"xr" = (
/obj/effect/turf_decal/stripes/white/line{
	dir = 8
	},
/turf/open/floor/iron/dark/smooth_large,
/area/misc/infiltrator_memory)
"xw" = (
/obj/structure/marker_beacon/burgundy{
	pixel_x = 8;
	pixel_y = 8
	},
/obj/effect/turf_decal/stripes/white/corner{
	dir = 8
	},
/turf/open/floor/iron/dark/textured_corner{
	dir = 4
	},
/area/misc/infiltrator_memory)
"yM" = (
/obj/structure/railing/unbreakable{
	dir = 8
	},
/obj/structure/railing/unbreakable{
	dir = 4
	},
/turf/open/floor/iron/stairs/old{
	dir = 1;
	color = "#7F7F7F";
	name = "airstair"
	},
/area/misc/infiltrator_memory)
"zb" = (
/obj/effect/turf_decal/siding/dark,
/turf/open/floor/plating,
/area/misc/infiltrator_memory)
"zh" = (
/obj/effect/turf_decal/siding/dark{
	dir = 9
	},
/turf/open/floor/plating,
/area/misc/infiltrator_memory)
"zk" = (
/obj/effect/turf_decal/vg_decals/numbers/nine,
/turf/open/floor/plating,
/area/misc/infiltrator_memory)
"zM" = (
/turf/closed/wall/r_wall/syndicate,
/area/misc/infiltrator_memory)
"AP" = (
/obj/effect/turf_decal/siding/dark{
	dir = 10
	},
/turf/open/floor/plating,
/area/misc/infiltrator_memory)
"AT" = (
/obj/item/paper/paperslip/corporate/syndicate,
/turf/open/floor/iron/dark/smooth_large,
/area/misc/infiltrator_memory)
"Br" = (
/obj/structure/lattice,
/turf/open/space,
/area/space/nearstation)
"BX" = (
/obj/effect/light_emitter/fake_outdoors,
/turf/open/floor/plating,
/area/misc/infiltrator_memory)
"CQ" = (
/obj/effect/turf_decal/siding/dark{
	dir = 1
	},
/turf/open/floor/plating,
/area/misc/infiltrator_memory)
"EI" = (
/obj/structure/marker_beacon/burgundy{
	pixel_x = -8;
	pixel_y = -8
	},
/turf/open/floor/iron/dark/textured_corner{
	dir = 8
	},
/area/misc/infiltrator_memory)
"Fj" = (
/obj/structure/railing/corner/end/flip/unbreakable{
	dir = 4
	},
/obj/structure/railing/corner/end/unbreakable{
	dir = 4
	},
/turf/open/floor/iron/dark/smooth_large,
/area/misc/infiltrator_memory)
"Gx" = (
/obj/effect/turf_decal/siding/dark/corner,
/obj/effect/turf_decal/vg_decals/numbers/nine,
/turf/open/floor/plating,
/area/misc/infiltrator_memory)
"Hl" = (
/obj/effect/light_emitter/thunderdome,
/turf/open/floor/catwalk_floor/iron_dark,
/area/misc/infiltrator_memory)
"IK" = (
/obj/machinery/light/floor,
/turf/open/floor/plating,
/area/misc/infiltrator_memory)
"Jd" = (
/obj/effect/turf_decal/siding/dark{
	dir = 4
	},
/obj/effect/turf_decal/vg_decals/numbers/nine,
/obj/effect/light_emitter/thunderdome,
/turf/open/floor/plating,
/area/misc/infiltrator_memory)
"Kt" = (
/obj/effect/turf_decal/stripes/white/line{
	dir = 9
	},
/turf/open/floor/iron/dark/smooth_large,
/area/misc/infiltrator_memory)
"KO" = (
/obj/structure/fluff/big_chain{
	pixel_y = 15
	},
/turf/open/floor/plating/reinforced,
/area/misc/infiltrator_memory)
"KQ" = (
/turf/open/floor/iron/dark/smooth_large,
/area/misc/infiltrator_memory)
"Lk" = (
/obj/effect/turf_decal/siding/dark{
	dir = 5
	},
/turf/open/floor/plating,
/area/misc/infiltrator_memory)
"Mc" = (
/obj/effect/turf_decal/siding/dark{
	dir = 5
	},
/obj/effect/turf_decal/siding/dark{
	dir = 1
	},
/turf/open/floor/plating,
/area/misc/infiltrator_memory)
"MV" = (
/obj/effect/landmark/start/infiltrator,
/turf/open/floor/iron/dark/smooth_large,
/area/misc/infiltrator_memory)
"Nh" = (
/obj/effect/turf_decal/stripes/white/line,
/turf/open/floor/iron/dark/smooth_large,
/area/misc/infiltrator_memory)
"ND" = (
/turf/open/floor/catwalk_floor/iron_dark,
/area/misc/infiltrator_memory)
"Ot" = (
/obj/effect/turf_decal/siding/dark{
	dir = 9
	},
/obj/effect/turf_decal/siding/dark{
	dir = 1
	},
/turf/open/floor/plating,
/area/misc/infiltrator_memory)
"Px" = (
/obj/effect/turf_decal/siding/dark/corner{
	dir = 1
	},
/turf/open/floor/plating,
/area/misc/infiltrator_memory)
"PV" = (
/obj/effect/turf_decal/siding/dark/corner{
	dir = 1
	},
/obj/effect/turf_decal/vg_decals/numbers/zero,
/turf/open/floor/plating,
/area/misc/infiltrator_memory)
"QZ" = (
/obj/effect/turf_decal/siding/dark{
	dir = 8
	},
/turf/open/floor/plating,
/area/misc/infiltrator_memory)
"Ro" = (
/obj/structure/railing/unbreakable,
/obj/structure/railing/unbreakable{
	dir = 1
	},
/turf/open/floor/iron/stairs/old{
	dir = 8;
	color = "#7F7F7F"
	},
/area/misc/infiltrator_memory)
"Rw" = (
/turf/open/floor/plating,
/area/misc/infiltrator_memory)
"Sc" = (
/obj/structure/railing/unbreakable,
/obj/structure/railing/unbreakable{
	dir = 1
	},
/turf/open/floor/iron/stairs/old{
	dir = 4;
	color = "#7F7F7F"
	},
/area/misc/infiltrator_memory)
"Sg" = (
/obj/effect/turf_decal/siding/dark{
	dir = 1
	},
/turf/open/floor/iron/dark/smooth_large,
/area/misc/infiltrator_memory)
"Vn" = (
/turf/closed/wall/r_wall/syndicate/nodiagonal,
/area/misc/infiltrator_memory)
"Vt" = (
/obj/effect/turf_decal/stripes/white/corner,
/obj/structure/marker_beacon/bronze{
	pixel_x = -8;
	pixel_y = 8
	},
/turf/open/floor/iron/dark/textured_corner{
	dir = 1
	},
/area/misc/infiltrator_memory)
"Xh" = (
/obj/effect/turf_decal/siding/dark{
	dir = 4
	},
/turf/open/floor/iron/dark/smooth_large,
/area/misc/infiltrator_memory)
"XX" = (
/obj/structure/marker_beacon/burgundy{
	pixel_x = -8;
	pixel_y = 8
	},
/obj/effect/turf_decal/stripes/white/corner,
/turf/open/floor/iron/dark/textured_corner{
	dir = 1
	},
/area/misc/infiltrator_memory)
"Zh" = (
/obj/effect/turf_decal/siding/dark{
	dir = 8
	},
/obj/effect/turf_decal/vg_decals/numbers/zero,
/obj/effect/light_emitter/thunderdome,
/turf/open/floor/plating,
/area/misc/infiltrator_memory)
"Zn" = (
/obj/structure/marker_beacon/bronze{
	pixel_x = -8;
	pixel_y = -8
	},
/obj/effect/turf_decal/siding/dark/corner{
	dir = 4
	},
/turf/open/floor/iron/dark/textured_corner{
	dir = 8
	},
/area/misc/infiltrator_memory)
"Zw" = (
/obj/effect/turf_decal/stripes/white/line{
	dir = 5
	},
/turf/open/floor/iron/dark/smooth_large,
/area/misc/infiltrator_memory)

(1,1,1) = {"
Rw
Rw
Rw
Rw
Rw
Rw
Rw
Rw
Rw
Rw
Rw
Rw
Rw
Rw
Rw
Rw
Rw
Rw
Rw
Rw
Rw
Rw
Rw
Rw
Rw
Rw
Rw
Rw
Rw
Rw
zM
lz
lz
lz
lz
lz
lz
lz
lz
"}
(2,1,1) = {"
Rw
Rw
Rw
Rw
Rw
Rw
Rw
Rw
Rw
Rw
Rw
Rw
Rw
Rw
Rw
Rw
Rw
Rw
Rw
Rw
Rw
Rw
Rw
Rw
Rw
Rw
Rw
Rw
Rw
Rw
zM
lz
lz
lz
lz
lz
lz
lz
lz
"}
(3,1,1) = {"
Rw
Rw
Rw
Rw
Rw
Rw
Rw
Rw
Rw
Rw
Rw
Rw
Rw
Rw
Rw
Rw
Rw
Rw
Rw
Rw
Rw
Rw
Rw
Rw
Rw
Rw
Rw
Rw
Rw
Rw
zM
lz
lz
lz
lz
lz
lz
lz
lz
"}
(4,1,1) = {"
Rw
Rw
Rw
Rw
Rw
Rw
Rw
Rw
Rw
Rw
Rw
Rw
Rw
Rw
Rw
hR
Rw
Rw
Rw
Rw
Rw
Rw
Rw
Rw
Rw
Rw
Rw
Rw
Rw
Rw
zM
mF
lz
lz
lz
lz
lz
hc
lz
"}
(5,1,1) = {"
Rw
Rw
Rw
Rw
Rw
Rw
Rw
Rw
BX
Rw
Rw
Rw
Rw
BX
Rw
hR
Rw
Rw
ul
ah
ah
ah
wQ
Rw
KO
Rw
Rw
Rw
KO
Rw
zM
iJ
zM
lz
lz
hc
hc
hc
lz
"}
(6,1,1) = {"
Rw
Rw
Rw
Rw
Rw
Rw
Rw
Rw
Rw
Rw
Rw
Rw
Rw
Rw
Rw
hR
Rw
Rw
zb
KQ
KQ
KQ
Mc
ah
ah
ah
ah
ah
ah
ah
wQ
Rw
zM
zM
lz
lz
hc
hc
lz
"}
(7,1,1) = {"
Rw
Rw
Rw
Rw
Rw
Rw
Rw
Rw
Rw
Rw
Rw
Rw
Rw
Rw
Rw
hR
Rw
Rw
zb
KQ
AT
KQ
Sg
xr
xr
xr
xr
xr
xr
Zw
Lk
wQ
at
Vn
zM
Br
Br
hc
lz
"}
(8,1,1) = {"
Rw
Rw
Rw
Rw
Rw
Rw
Rw
Rw
Rw
Rw
Rw
Rw
Rw
Rw
Rw
hR
Rw
Rw
zb
KQ
Fj
KQ
Sg
sz
ND
ND
ND
ND
ND
xw
Zw
Lk
wQ
gM
fv
to
Br
hc
lz
"}
(9,1,1) = {"
Rw
Rw
Rw
Rw
Rw
Rw
Rw
Rw
Rw
Rw
Rw
Rw
Rw
Rw
Rw
hR
Rw
Rw
fO
AP
Ro
jj
vQ
ND
zh
QZ
QZ
QZ
AP
ND
ty
Zw
Lk
wQ
fv
to
to
hc
lz
"}
(10,1,1) = {"
Rw
Rw
Rw
Rw
Rw
Rw
Rw
Rw
Rw
Rw
Rw
Rw
Rw
Rw
Rw
hR
Rw
Rw
Rw
zb
wT
sz
ND
zh
Px
Rw
Rw
Rw
fO
AP
ND
xw
Zw
CQ
Rw
fv
to
hc
lz
"}
(11,1,1) = {"
Rw
Rw
Rw
Rw
Rw
Rw
Rw
Rw
Rw
Rw
Rw
Rw
Rw
Rw
Rw
hR
ah
ah
ah
kJ
KQ
ND
zh
PV
Rw
Rw
IK
Rw
qe
cy
AP
ND
Nh
CQ
Rw
fv
to
to
lz
"}
(12,1,1) = {"
Rw
Rw
Rw
Rw
Rw
Rw
Rw
Rw
Rw
Rw
Rw
Rw
Rw
Rw
Rw
hR
KQ
KQ
KQ
KQ
KQ
ND
Lk
Jd
wQ
Rw
Rw
Rw
Rw
zk
zb
ND
Nh
CQ
Rw
Rw
fv
to
lz
"}
(13,1,1) = {"
Rw
Rw
Rw
Rw
Rw
Rw
Rw
Rw
BX
Rw
Rw
Rw
Rw
BX
Rw
hR
KQ
MV
KQ
KQ
KQ
kA
yM
yM
rq
Rw
Rw
Rw
Rw
Rw
zb
Hl
Nh
CQ
Rw
Rw
fv
to
lz
"}
(14,1,1) = {"
Rw
Rw
Rw
Rw
Rw
Rw
Rw
Rw
Rw
Rw
Rw
Rw
Rw
Rw
Rw
hR
KQ
KQ
KQ
KQ
KQ
ND
zh
Zh
Px
Rw
Rw
Rw
Rw
pI
zb
ND
Nh
CQ
Rw
Rw
fv
to
lz
"}
(15,1,1) = {"
Rw
Rw
Rw
Rw
Rw
Rw
Rw
Rw
Rw
Rw
Rw
Rw
Rw
Rw
Rw
hR
QZ
QZ
QZ
AP
KQ
ND
Lk
eM
Rw
Rw
IK
Rw
qe
Gx
kJ
ND
Nh
CQ
Rw
fv
to
to
lz
"}
(16,1,1) = {"
Rw
Rw
Rw
Rw
Rw
Rw
Rw
Rw
Rw
Rw
Rw
Rw
Rw
Rw
Rw
hR
Rw
Rw
Rw
zb
Fj
EI
ND
Lk
wQ
Rw
Rw
Rw
ul
kJ
ND
XX
Kt
CQ
Rw
fv
to
hc
lz
"}
(17,1,1) = {"
Rw
Rw
Rw
Rw
Rw
Rw
Rw
Rw
Rw
Rw
Rw
Rw
Rw
Rw
Rw
hR
Rw
Rw
ul
kJ
Sc
Xh
Zn
ND
Lk
ah
ah
ah
kJ
ND
Vt
Kt
zh
Px
fv
to
to
lz
lz
"}
(18,1,1) = {"
Rw
Rw
Rw
Rw
Rw
Rw
Rw
Rw
Rw
Rw
Rw
Rw
Rw
Rw
Rw
hR
Rw
Rw
zb
KQ
wT
KQ
Sg
EI
ND
ND
ND
ND
ND
XX
Kt
zh
Px
vs
fv
to
Br
lz
lz
"}
(19,1,1) = {"
Rw
Rw
Rw
Rw
Rw
Rw
Rw
Rw
Rw
Rw
Rw
Rw
Rw
Rw
Rw
hR
Rw
Rw
zb
KQ
KQ
KQ
Sg
rm
rm
rm
rm
rm
rm
Kt
zh
Px
at
Vn
zM
mF
mF
lz
lz
"}
(20,1,1) = {"
Rw
Rw
Rw
Rw
Rw
Rw
Rw
Rw
Rw
Rw
Rw
Rw
Rw
Rw
Rw
hR
Rw
Rw
zb
KQ
KQ
KQ
Ot
QZ
QZ
QZ
QZ
QZ
QZ
QZ
Px
Rw
zM
zM
hc
hc
lz
lz
lz
"}
(21,1,1) = {"
Rw
Rw
Rw
Rw
Rw
Rw
Rw
Rw
BX
Rw
Rw
Rw
Rw
BX
Rw
hR
Rw
Rw
fO
QZ
QZ
QZ
Px
Rw
KO
Rw
Rw
Rw
KO
Rw
zM
iJ
zM
lz
hc
hc
lz
lz
lz
"}
(22,1,1) = {"
Rw
Rw
Rw
Rw
Rw
Rw
Rw
Rw
Rw
Rw
Rw
Rw
Rw
Rw
Rw
hR
Rw
Rw
Rw
Rw
Rw
Rw
Rw
Rw
Rw
Rw
Rw
Rw
Rw
Rw
zM
mF
lz
lz
lz
lz
lz
lz
lz
"}
(23,1,1) = {"
Rw
Rw
Rw
Rw
Rw
Rw
Rw
Rw
Rw
Rw
Rw
Rw
Rw
Rw
Rw
Rw
Rw
Rw
Rw
Rw
Rw
Rw
Rw
Rw
Rw
Rw
Rw
Rw
Rw
Rw
zM
lz
lz
lz
lz
lz
lz
lz
lz
"}
(24,1,1) = {"
Rw
Rw
Rw
Rw
Rw
Rw
Rw
Rw
Rw
Rw
Rw
Rw
Rw
Rw
Rw
Rw
Rw
Rw
Rw
Rw
Rw
Rw
Rw
Rw
Rw
Rw
Rw
Rw
Rw
Rw
zM
lz
lz
lz
lz
lz
lz
lz
lz
"}
(25,1,1) = {"
Rw
Rw
Rw
Rw
Rw
Rw
Rw
Rw
Rw
Rw
Rw
Rw
Rw
Rw
Rw
Rw
Rw
Rw
Rw
Rw
Rw
Rw
Rw
Rw
Rw
Rw
Rw
Rw
Rw
Rw
zM
lz
lz
lz
lz
lz
lz
lz
lz
"}
