//MAP CONVERTED BY dmm2tgm.py THIS HEADER COMMENT PREVENTS RECONVERSION, DO NOT REMOVE
"a" = (
/turf/open/space/basic,
/area/space)
"p" = (
/turf/open/indestructible,
/area/space)
"s" = (
/turf/closed/indestructible/reinforced,
/area/space)
"u" = (
/obj/effect/landmark/start/lone_infil,
/turf/open/indestructible,
/area/space)
"y" = (
/obj/item/flashlight/lamp/bananalamp,
/turf/open/indestructible,
/area/space)

(1,1,1) = {"
a
a
a
a
a
a
a
a
a
a
a
a
a
a
a
a
a
a
a
a
"}
(2,1,1) = {"
a
a
a
a
a
a
a
a
a
a
a
a
a
a
a
a
a
a
a
a
"}
(3,1,1) = {"
a
a
a
a
a
a
a
a
a
a
a
a
a
a
a
a
a
a
a
a
"}
(4,1,1) = {"
a
a
a
a
a
a
a
a
a
a
a
a
a
a
a
a
a
a
a
a
"}
(5,1,1) = {"
a
a
a
a
a
a
a
a
a
a
a
a
a
a
a
a
a
a
a
a
"}
(6,1,1) = {"
a
a
a
a
a
a
a
a
a
a
a
a
a
a
a
a
a
a
a
a
"}
(7,1,1) = {"
a
a
a
a
a
a
a
a
a
a
a
a
a
a
a
a
a
a
a
a
"}
(8,1,1) = {"
a
a
a
a
a
a
a
s
s
s
s
s
s
a
a
a
a
a
a
a
"}
(9,1,1) = {"
a
a
a
a
a
a
a
s
p
p
p
p
s
a
a
a
a
a
a
a
"}
(10,1,1) = {"
a
a
a
a
a
a
a
s
p
y
p
p
s
a
a
a
a
a
a
a
"}
(11,1,1) = {"
a
a
a
a
a
a
a
s
p
p
u
p
s
a
a
a
a
a
a
a
"}
(12,1,1) = {"
a
a
a
a
a
a
a
s
p
p
p
p
s
a
a
a
a
a
a
a
"}
(13,1,1) = {"
a
a
a
a
a
a
a
s
s
s
s
s
s
a
a
a
a
a
a
a
"}
(14,1,1) = {"
a
a
a
a
a
a
a
a
a
a
a
a
a
a
a
a
a
a
a
a
"}
(15,1,1) = {"
a
a
a
a
a
a
a
a
a
a
a
a
a
a
a
a
a
a
a
a
"}
(16,1,1) = {"
a
a
a
a
a
a
a
a
a
a
a
a
a
a
a
a
a
a
a
a
"}
(17,1,1) = {"
a
a
a
a
a
a
a
a
a
a
a
a
a
a
a
a
a
a
a
a
"}
(18,1,1) = {"
a
a
a
a
a
a
a
a
a
a
a
a
a
a
a
a
a
a
a
a
"}
(19,1,1) = {"
a
a
a
a
a
a
a
a
a
a
a
a
a
a
a
a
a
a
a
a
"}
(20,1,1) = {"
a
a
a
a
a
a
a
a
a
a
a
a
a
a
a
a
a
a
a
a
"}
