//MAP CONVERTED BY dmm2tgm.py THIS HEADER COMMENT PREVENTS RECONVERSION, DO NOT REMOVE
"a" = (
/turf/open/floor/iron/dark,
/area/infiltrator_memory)
"h" = (
/turf/open/floor/iron/dark,
/area/infiltrator_memory/landing_pad)
"n" = (
/obj/effect/landmark/start/lone_infil,
/obj/effect/light_emitter/fake_outdoors,
/turf/open/floor/iron/dark,
/area/infiltrator_memory)
"p" = (
/obj/docking_port/stationary{
	dir = 2;
	roundstart_template = /datum/map_template/shuttle/lone_infil/default;
	shuttle_id = "lone_infil";
	width = 9;
	height = 5;
	dwidth = 4;
	name = "Landing Pad"
	},
/turf/open/floor/iron/dark,
/area/infiltrator_memory/landing_pad)
"D" = (
/obj/effect/light_emitter/fake_outdoors,
/turf/open/floor/iron/dark,
/area/infiltrator_memory)
"Z" = (
/obj/effect/light_emitter/fake_outdoors,
/turf/open/floor/iron/dark,
/area/infiltrator_memory/landing_pad)

(1,1,1) = {"
a
a
a
a
a
a
a
a
a
a
a
a
a
a
a
a
a
a
a
a
a
a
a
a
a
"}
(2,1,1) = {"
a
a
a
a
a
a
a
a
a
a
a
a
a
a
a
a
a
a
a
a
a
a
a
a
a
"}
(3,1,1) = {"
a
a
D
a
a
a
a
a
a
a
a
D
a
a
a
a
a
h
h
h
h
h
Z
h
h
"}
(4,1,1) = {"
a
a
a
a
a
a
a
a
a
a
a
a
a
a
a
a
a
h
h
h
h
h
h
h
h
"}
(5,1,1) = {"
a
a
a
a
a
a
a
a
a
a
a
a
a
a
a
a
a
h
h
h
h
h
h
h
h
"}
(6,1,1) = {"
a
a
a
a
a
a
a
a
a
a
a
a
a
a
a
a
a
h
h
h
h
h
h
h
h
"}
(7,1,1) = {"
a
a
a
a
a
a
D
a
a
a
a
a
a
a
a
a
a
h
Z
h
h
h
h
h
h
"}
(8,1,1) = {"
a
a
a
a
a
a
a
a
a
a
a
D
a
a
a
a
a
h
h
h
h
h
h
h
h
"}
(9,1,1) = {"
a
a
a
a
a
a
a
a
a
a
a
a
a
a
a
a
a
h
h
h
h
h
h
h
h
"}
(10,1,1) = {"
a
a
a
a
a
a
a
a
a
a
a
a
a
a
a
a
a
h
h
h
h
h
h
h
h
"}
(11,1,1) = {"
a
a
a
a
a
a
a
a
a
a
a
a
a
a
a
a
a
h
h
h
h
h
h
h
h
"}
(12,1,1) = {"
a
a
a
a
a
a
a
a
a
a
a
a
a
a
a
a
a
h
h
h
h
h
h
h
h
"}
(13,1,1) = {"
a
a
D
a
a
a
D
a
a
a
a
n
a
a
a
a
a
Z
h
p
h
h
Z
h
h
"}
(14,1,1) = {"
a
a
a
a
a
a
a
a
a
a
a
a
a
a
a
a
a
h
h
h
h
h
h
h
h
"}
(15,1,1) = {"
a
a
a
a
a
a
a
a
a
a
a
a
a
a
a
a
a
h
h
h
h
h
h
h
h
"}
(16,1,1) = {"
a
a
a
a
a
a
a
a
a
a
a
a
a
a
a
a
a
h
h
h
h
h
h
h
h
"}
(17,1,1) = {"
a
a
a
a
a
a
a
a
a
a
a
a
a
a
a
a
a
h
h
h
h
h
h
h
h
"}
(18,1,1) = {"
a
a
a
a
a
a
a
a
a
a
a
a
a
a
a
a
a
h
h
h
h
h
h
h
h
"}
(19,1,1) = {"
a
a
a
a
a
a
a
a
a
a
a
D
a
a
a
a
a
h
h
h
h
h
h
h
h
"}
(20,1,1) = {"
a
a
a
a
a
a
a
a
a
a
a
a
a
a
a
a
a
h
h
h
h
h
h
h
h
"}
(21,1,1) = {"
a
a
a
a
a
D
a
a
a
a
a
a
a
a
a
a
a
h
Z
h
h
h
h
h
h
"}
(22,1,1) = {"
a
a
a
a
a
a
a
a
a
a
a
a
a
a
a
a
a
h
h
h
h
h
h
h
h
"}
(23,1,1) = {"
a
a
a
a
a
a
a
a
a
a
a
a
a
a
a
a
a
h
h
h
h
h
h
h
h
"}
(24,1,1) = {"
a
a
D
a
a
a
a
a
a
a
a
D
a
a
a
a
a
a
a
a
a
a
D
a
a
"}
(25,1,1) = {"
a
a
a
a
a
a
a
a
a
a
a
a
a
a
a
a
a
a
a
a
a
a
a
a
a
"}
