//MAP CONVERTED BY dmm2tgm.py THIS HEADER COMMENT PREVENTS RECONVERSION, DO NOT REMOVE
"a" = (
/turf/closed/wall/prefab_plastic,
/area/template_noop)
"w" = (
/turf/open/floor/plastic{
	initial_gas_mix = "TEMP=2.7"
	},
/area/template_noop)

(1,1,1) = {"
a
a
a
a
a
a
a
"}
(2,1,1) = {"
a
w
w
w
w
w
a
"}
(3,1,1) = {"
a
w
w
w
w
w
a
"}
(4,1,1) = {"
a
w
w
w
w
w
a
"}
(5,1,1) = {"
a
w
w
w
w
w
a
"}
(6,1,1) = {"
a
w
w
w
w
w
a
"}
(7,1,1) = {"
a
a
a
a
a
a
a
"}
